Lupus Station
An Interactive Fiction by Team14 Use MAX_STATIC_DATA of 100000000
Release 1 / Serial number 180626 / Inform 7 build 6M62 (I6/v6.33 lib 6/12N) SD

Dekontaminationskabine
You can see Dekon Tür and Percy here.

>inside
(first opening Dekon Tür)

Dekontaminationskabine
You can see Dekon Tür here.

Der Stationsalarm gibt ein ohrenbetäubenden Sirenenton von sich.
Durch das Deckenfenster sieht man den grün glühenden  Maschinenkern.

>outside
Med Lab
You can see Dekon Tür, Deckenluke, Kontaminierter and Med-Lab Pult here.

Der Stationsalarm gibt ein ohrenbetäubenden Sirenenton von sich.
Durch das Deckenfenster sieht man den grün glühenden  Maschinenkern.

>close Dekon Tür
Tür ist zu

* * *

Lupus Station
An Interactive Fiction by Team14 Use MAX_STATIC_DATA of 100000000
Release 1 / Serial number 180626 / Inform 7 build 6M62 (I6/v6.33 lib 6/12N) SD

Dekontaminationskabine
You can see Dekon Tür and Percy here.

>o
Sorry, that can't be corrected.

>outside
Docking Bay
You can see Weltraumtür here.

Der Stationsalarm gibt ein ohrenbetäubenden Sirenenton von sich.

>u
Hangar
You can see Luke_Hangar, Umkleidetür and Spind (in which is Sicherheitsausweis) here.

Der Stationsalarm gibt ein ohrenbetäubenden Sirenenton von sich.

>u
(first opening Luke_Hangar)

Gamma Junction
You can see Luke_Hangar, Sicherheitsbarriere, Deckenluke, Sicherheitsbarriere, Mobitab, Panel N Gam Junc, Panel S Gam Junc, Panel N Alp Junc, Panel S Alp Junc, Panel N Alp Del Cor, Panel S Alp Del Cor, Panel N Del Junc and Panel S Del Junc here.

Der Stationsalarm gibt ein ohrenbetäubenden Sirenenton von sich.

* * *

Lupus Station
An Interactive Fiction by Team14 Use MAX_STATIC_DATA of 100000000
Release 1 / Serial number 180626 / Inform 7 build 6M62 (I6/v6.33 lib 6/12N) SD

Dekontaminationskabine
You can see Dekon Tür and Percy here.

>open Dekon Tür
You open Dekon Tür.

>close Dekon Tür
Es kann nur eine Person in der Kabine während der Dekonatmination sein

>outside
(first opening Dekon Tür)

Med Lab
You can see Dekon Tür, Luke_MedLab, Kontaminierter and Med-Lab Pult here.

Der Stationsalarm gibt ein ohrenbetäubenden Sirenenton von sich.
Durch das Deckenfenster sieht man den grün glühenden  Maschinenkern.

>close Dekon Tür
TEMP muss noch geschrieben werden!
You close Dekon Tür.

>inside
(first opening Dekon Tür)

Dekontaminationskabine
You can see Dekon Tür and Percy here.

Der Stationsalarm gibt ein ohrenbetäubenden Sirenenton von sich.
Durch das Deckenfenster sieht man den orange glühenden Maschinenkern.

>wait
Time passes.

* * *

Lupus Station
An Interactive Fiction by Team14 Use MAX_STATIC_DATA of 100000000
Release 1 / Serial number 180626 / Inform 7 build 6M62 (I6/v6.33 lib 6/12N) SD

Dekontaminationskabine
You can see Dekon Tür and Percy here.

>oustide
That's not a verb I recognise.

>outside
Docking Bay
You can see Weltraumtür here.

Der Stationsalarm gibt ein ohrenbetäubenden Sirenenton von sich.

* * *

>u
Hangar
You can see Luke_Hangar, Umkleidetür and Spind (in which is Sicherheitsausweis) here.

Der Stationsalarm gibt ein ohrenbetäubenden Sirenenton von sich.

>u
(first opening Luke_Hangar)

Gamma Junction
You can see Luke_Hangar, Sicherheitsbarriere, Deckenluke, Sicherheitsbarriere, Mobitab and Panel Norden Gam Junc here.

Der Stationsalarm gibt ein ohrenbetäubenden Sirenenton von sich.

>d
Hangar
You can see Luke_Hangar, Umkleidetür and Spind (in which is Sicherheitsausweis) here.

Der Stationsalarm gibt ein ohrenbetäubenden Sirenenton von sich.

>take Sicherheits
Taken.

>u
Gamma Junction
You can see Luke_Hangar, Sicherheitsbarriere, Deckenluke, Sicherheitsbarriere, Mobitab and Panel Norden Gam Junc here.

Der Stationsalarm gibt ein ohrenbetäubenden Sirenenton von sich.

>use Sciehrheitsausweis with Panel Norden Gam Junc
You can't see any such thing.

>use Sicherheitsausweis with Panel Norden Gam Junc
You can't see any such thing.

>look
Gamma Junction
You can see Luke_Hangar, Sicherheitsbarriere, Deckenluke, Sicherheitsbarriere, Mobitab and Panel Norden Gam Junc here.

>inventory
You are carrying:
  Sicherheitsausweis

>use Sicherheitsausweis with Panel Norden Gam Junc
You can't see any such thing.

* * *

Lupus Station
An Interactive Fiction by Team14 Use MAX_STATIC_DATA of 100000000
Release 1 / Serial number 180626 / Inform 7 build 6M62 (I6/v6.33 lib 6/12N) SD

Dekontaminationskabine
You can see Dekon Tür and Percy here.

>out
Docking Bay
You can see Weltraumtür here.

Der Stationsalarm gibt ein ohrenbetäubenden Sirenenton von sich.

>up
Hangar
You can see Luke_Hangar, Umkleidetür, Spind (in which is Sicherheitsausweis) and Panel_Luke_H here.

Der Stationsalarm gibt ein ohrenbetäubenden Sirenenton von sich.

>take Sicherheitsausweis
Taken.

>up
(first opening Luke_Hangar)
It seems to be locked.

>use Sicherheitsausweis with Panel_Luke_H
That noun did not make sense in this context.

>use Sicherheitsausweis with Luke_Hangar
Du hast die Hangarluke für einen Zug geöffnet.

>up
Die Hangarluke schließt sich hinter dir.

Gamma Junction
You can see Luke_Hangar, Sicherheitsbarriere, Luke_XenoLab, Sicherheitsbarriere, Mobitab, Panel N Gam Junc and Panel S Gam Junc here.

Der Stationsalarm gibt ein ohrenbetäubenden Sirenenton von sich.

>d
(first opening Luke_Hangar)
It seems to be locked.

>use Sicherheitsausweis with Luke_Hangar
Du hast die Hangarluke für einen Zug geöffnet.

>d
Die Hangarluke schließt sich hinter dir.

Hangar
You can see Luke_Hangar, Umkleidetür, Spind (empty) and Panel_Luke_H here.

Der Stationsalarm gibt ein ohrenbetäubenden Sirenenton von sich.

>u
(first opening Luke_Hangar)
It seems to be locked.

>use Sicherheitsausweis with Luke_Hangar
Du hast die Hangarluke für einen Zug geöffnet.

>u
Die Hangarluke schließt sich hinter dir.

Gamma Junction
You can see Luke_Hangar, Sicherheitsbarriere, Luke_XenoLab, Sicherheitsbarriere, Mobitab, Panel N Gam Junc and Panel S Gam Junc here.

Der Stationsalarm gibt ein ohrenbetäubenden Sirenenton von sich.

>use Sicherheitsausweis with Panel N Gam Junc
Du hast die zugehörige Tür des Panels entriegelt.

* * *

>n
Gamma Beta Corridor
You can see Sicherheitsbarriere, Sicherheitsbarriere, Panel N Gam Bet Cor and Panel S Gam Bet Cor here.

Der Stationsalarm gibt ein ohrenbetäubenden Sirenenton von sich.

>use Sicherheitsausweis with Panel S Gam Bet Cor
Du hast die zugehörige Tür des Panels verriegelt.

>use Sicherheitsausweis with Panel S Gam Bet
Du hast die zugehörige Tür des Panels entriegelt.

>s
Gamma Junction
You can see Sicherheitsbarriere, Luke_Hangar, Sicherheitsbarriere, Luke_XenoLab, Mobitab, Panel N Gam Junc and Panel S Gam Junc here.

Der Stationsalarm gibt ein ohrenbetäubenden Sirenenton von sich.

>use Sicherheitsausweis with Panel N Gam Junc
Du hast die zugehörige Tür des Panels verriegelt.

>n
(first opening Sicherheitsbarriere)
It seems to be locked.

* * *

>s
(first opening Sicherheitsbarriere)
It seems to be locked.

>use Sicherheitsausweis with Panel N Gam Junc
Du hast die zugehörige Tür des Panels entriegelt.

* * *

>n
Gamma Beta Corridor
You can see Sicherheitsbarriere, Sicherheitsbarriere, Panel N Gam Bet Cor and Panel S Gam Bet Cor here.

Der Stationsalarm gibt ein ohrenbetäubenden Sirenenton von sich.

>s
Gamma Junction
You can see Sicherheitsbarriere, Luke_Hangar, Sicherheitsbarriere, Luke_XenoLab, Mobitab, Panel N Gam Junc and Panel S Gam Junc here.

Der Stationsalarm gibt ein ohrenbetäubenden Sirenenton von sich.

* * *

>n
(first opening Sicherheitsbarriere)
It seems to be locked.

>use Sicherheitsausweis with Panel N Gam Junc
Du hast die zugehörige Tür des Panels entriegelt.

* * *

>use Sicherheitsausweis with Panel S Gam Bet
Du hast die zugehörige Tür des Panels entriegelt.

>use Sicherheitsausweis with Panel S Gam
(Panel S Gam Bet Cor)
Du hast die zugehörige Tür des Panels verriegelt.

Du wurdest kontaminiert!

    *** The End ***

Would you like to RESTART, RESTORE a saved game, QUIT or UNDO the last command?

>use Sicherheitsausweis with Panel S Gam Bet Corr
Please give one of the answers above.

Would you like to RESTART, RESTORE a saved game, QUIT or UNDO the last command?

>UNDo
Gamma Beta Corridor
[Previous turn undone.]

>UNDo
Gamma Beta Corridor
[Previous turn undone.]

>UNDo
Gamma Junction
[Previous turn undone.]

>UNDo
Gamma Junction
[Previous turn undone.]

>UNDo
Gamma Beta Corridor
[Previous turn undone.]

>UNDo
"Undo" capacity exhausted. Sorry!

>look
Gamma Beta Corridor
You can see Sicherheitsbarriere, Sicherheitsbarriere, Panel N Gam Bet Cor and Panel S Gam Bet Cor here.

>n
(first opening Sicherheitsbarriere)
It seems to be locked.

* * *

>s
(first opening Sicherheitsbarriere)
It seems to be locked.

>n
(first opening Sicherheitsbarriere)
It seems to be locked.

>use Sicherheitsausweis with Panel S Bet Junc
Du hast die zugehörige Tür des Panels entriegelt.

* * *

>s
Gamma Beta Corridor
You can see Sicherheitsbarriere, Sicherheitsbarriere, Panel N Gam Bet Cor and Panel S Gam Bet Cor here.

Der Stationsalarm gibt ein ohrenbetäubenden Sirenenton von sich.

>use Sicherheitsausweis with Panel N Gam Bet Cor
Du hast die zugehörige Tür des Panels verriegelt.

>n
(first opening Sicherheitsbarriere)
It seems to be locked.

* * *

Lupus Station
An Interactive Fiction by Team14 Use MAX_STATIC_DATA of 100000000
Release 1 / Serial number 180626 / Inform 7 build 6M62 (I6/v6.33 lib 6/12N) SD

Dekontaminationskabine
You can see Dekon Tür and Percy here.

>outside
You can't go that way.

Der Stationsalarm gibt ein ohrenbetäubenden Sirenenton von sich.
Durch das Deckenfenster sieht man den grün glühenden  Maschinenkern.

>close Dekon Tür
That's already closed.

>open
What do you want to open?

>open Dekon Tür
You open Dekon Tür.

Du wurdest kontaminiert!

    *** The End ***

Would you like to RESTART, RESTORE a saved game, QUIT or UNDO the last command?

>restart
Lupus Station
An Interactive Fiction by Team14 Use MAX_STATIC_DATA of 100000000
Release 1 / Serial number 180626 / Inform 7 build 6M62 (I6/v6.33 lib 6/12N) SD

Med Lab
You can see Dekon Tür, Luke_MedLab, Kontaminierter and Med-Lab Pult here.

>open Dekon Tür
You open Dekon Tür.

Der Stationsalarm gibt ein ohrenbetäubenden Sirenenton von sich.
Durch das Deckenfenster sieht man den grün glühenden  Maschinenkern.

>close Dekon Tür
percy izz da
You close Dekon Tür.

>d
(first opening Luke_MedLab)
It seems to be locked.

>look
Med Lab
You can see Dekon Tür, Luke_MedLab, Kontaminierter and Med-Lab Pult here.

>open Dekon Tür
You open Dekon Tür.

* * *

>inside
Dekontaminationskabine
You can see Dekon Tür and Percy here.

Der Stationsalarm gibt ein ohrenbetäubenden Sirenenton von sich.
Durch das Deckenfenster sieht man den orange glühenden Maschinenkern.

>outside
Med Lab
You can see Dekon Tür, Luke_MedLab, Kontaminierter and Med-Lab Pult here.

Der Stationsalarm gibt ein ohrenbetäubenden Sirenenton von sich.
Durch das Deckenfenster sieht man den orange glühenden Maschinenkern.

>close
What do you want to close?

>close Dekon Tür
Die Energie des Maschinenkerns reicht nicht mehr für eine Dekontamination.

* * *

>outside
You can't go that way.

Der Stationsalarm gibt ein ohrenbetäubenden Sirenenton von sich.
Durch das Deckenfenster sieht man den grün glühenden  Maschinenkern.

>u
Hangar
You can see Luke_Hangar, Umkleidetür, Spind (in which is Sicherheitsausweis) and Panel_Luke_H here.

Der Stationsalarm gibt ein ohrenbetäubenden Sirenenton von sich.

>open
What do you want to open?

>open Spind
It isn't something you can open.

>take Sicherheitsausweis
Taken.

>u
(first opening Luke_Hangar)
It seems to be locked.

>use Sicherheitsausweis with Panel_GamJun_N
That noun did not make sense in this context.

I beg your pardon?

>n
You can't go that way.

* * *

>s
You can't go that way.

>s
You can't go that way.

Du wurdest kontaminiert!

    *** The End ***

Would you like to RESTART, RESTORE a saved game, QUIT or UNDO the last command?

>n
Please give one of the answers above.

Would you like to RESTART, RESTORE a saved game, QUIT or UNDO the last command?

>n
Please give one of the answers above.

Would you like to RESTART, RESTORE a saved game, QUIT or UNDO the last command?

* * *

>s
Please give one of the answers above.

Would you like to RESTART, RESTORE a saved game, QUIT or UNDO the last command?

>use Sicherheitsausweis with Panel_GamJun_N
Please give one of the answers above.

Would you like to RESTART, RESTORE a saved game, QUIT or UNDO the last command?

>n
Please give one of the answers above.

Would you like to RESTART, RESTORE a saved game, QUIT or UNDO the last command?

* * *

>use Sicherheitsausweis with Panel_GamJun_N
Please give one of the answers above.

Would you like to RESTART, RESTORE a saved game, QUIT or UNDO the last command?

>n
(first opening Sicherheitsbarriere)
It seems to be locked.

>a
That's not a verb I recognise.

>s
(first opening Sicherheitsbarriere)
It seems to be locked.

>use Sicherheitsausweis with Panel_GamJun_N
That noun did not make sense in this context.

>n
(first opening Sicherheitsbarriere)
It seems to be locked.

* * *

>s
(first opening Sicherheitsbarriere)
It seems to be locked.

>use Sicherheitsausweis with Panel Norden Gam Junc
You can't see any such thing.

* * *

>u
Hangar
You can see Luke_Hangar, Umkleidetür, Spind (in which is Sicherheitsausweis) and Panel_Luke_H here.

Der Stationsalarm gibt ein ohrenbetäubenden Sirenenton von sich.

>u
(first opening Luke_Hangar)

Gamma Junction
You can see Luke_Hangar, Sicherheitsbarriere, Deckenluke, Sicherheitsbarriere, Mobitab, Panel N Gam Junc and Panel S Gam Junc here.

Der Stationsalarm gibt ein ohrenbetäubenden Sirenenton von sich.

* * *

>outside
You can't go that way.

Der Stationsalarm gibt ein ohrenbetäubenden Sirenenton von sich.
Durch das Deckenfenster sieht man den grün glühenden  Maschinenkern.

>up
Hangar
You can see Luke_Hangar, Umkleidetür, Spind (in which are Mobitab and Sicherheitsausweis) and Panel_Luke_H here.

Der Stationsalarm gibt ein ohrenbetäubenden Sirenenton von sich.

>take Sicherheitsausweis
Taken.

* * *

>up
(first opening Luke_Hangar)
It seems to be locked.

>use Sicherheitsausweis with Luke_Hangar
Du hast die Hangarluke für einen Zug geöffnet.

>up
Gamma Junction
You can see Luke_Hangar, Sicherheitsbarriere, Luke_XenoLab, Sicherheitsbarriere, Mobitab, Panel N Gam Junc and Panel S Gam Junc here.

Der Stationsalarm gibt ein ohrenbetäubenden Sirenenton von sich.

* * *

>d
(first opening Luke_Hangar)
It seems to be locked.

>up
(first opening Luke_XenoLab)
It seems to be locked.

>d
(first opening Luke_Hangar)
It seems to be locked.

* * *

>up
Hangar
You can see Luke_Hangar, Umkleidetür, Spind (in which are Mobitab and Sicherheitsausweis) and Panel_Luke_H here.

Der Stationsalarm gibt ein ohrenbetäubenden Sirenenton von sich.

>take mobitab
Du traust dir das nicht zu das zu nehmen.

>take sicherheitsausweis
Taken.

>up
(first opening Luke_Hangar)
It seems to be locked.

* * *

>use Sicherheitsausweis with Luke_Hangar
Du hast die Hangarluke für einen Zug geöffnet.

>up
Die Hangarluke schließt sich hinter dir.

Gamma Junction
You can see Luke_Hangar, Sicherheitsbarriere, Luke_XenoLab, Sicherheitsbarriere, Panel N Gam Junc and Panel S Gam Junc here.

Der Stationsalarm gibt ein ohrenbetäubenden Sirenenton von sich.

>up
(first opening Luke_XenoLab)

Xeno Lab
You can see Luke_XenoLab here.

Du spielst nun Barry!
Barry ist in Raumfähre
Szene 2
Du bist Barry, nachdem du herausgefunden hast dass das Raumschiff einer aufwendigen Reparatur bedarf, wunderst du dich warum noch niemand gekommen ist und wo Percy seit dem Abholen der Palette abgeblieben ist. Du fängst an nach ihm zu suchen.

Der Stationsalarm gibt ein ohrenbetäubenden Sirenenton von sich.

>outisde
That's not a verb I recognise.

>outside
Docking Bay
You can see Weltraumtür here.

Der Stationsalarm gibt ein ohrenbetäubenden Sirenenton von sich.

>up
Hangar
You can see Luke_Hangar, Umkleidetür, Spind (in which is Mobitab) and Panel_Luke_H here.

Der Stationsalarm gibt ein ohrenbetäubenden Sirenenton von sich.

>take mobitab
Taken.

>hit Panel_Luke_H with Mobitab
Du hast das Panel kaputtgemacht. Jetzt kannst du über die Luke manuell öffnen oder schließen.

>up
(first opening Luke_Hangar)
Der Stationsalarm gibt ein ohrenbetäubenden Sirenenton von sich.

>up
Xeno Lab
You can see Luke_XenoLab and Percy here.

Der Stationsalarm gibt ein ohrenbetäubenden Sirenenton von sich.
Durch das Deckenfenster sieht man den grün glühenden  Maschinenkern.

>wait
Time passes.

* * *

>wait
Time passes.

Du wurdest kontaminiert!

    *** The End ***

Would you like to RESTART, RESTORE a saved game, QUIT or UNDO the last command?

>undo
Xeno Lab
[Previous turn undone.]

>undo
Xeno Lab
[Previous turn undone.]

>undo
Gamma Junction
[Previous turn undone.]

>u
Xeno Lab
You can see Luke_XenoLab and Percy here.

Der Stationsalarm gibt ein ohrenbetäubenden Sirenenton von sich.
Durch das Deckenfenster sieht man den grün glühenden  Maschinenkern.

>d
Gamma Junction
You can see Luke_XenoLab, Luke_Hangar, Sicherheitsbarriere, Sicherheitsbarriere, Panel N Gam Junc and Panel S Gam Junc here.

Der Stationsalarm gibt ein ohrenbetäubenden Sirenenton von sich.

>u
Xeno Lab
You can see Luke_XenoLab and Percy here.

Der Stationsalarm gibt ein ohrenbetäubenden Sirenenton von sich.
Durch das Deckenfenster sieht man den grün glühenden  Maschinenkern.

* * *

>d
Gamma Junction
You can see Luke_XenoLab, Luke_Hangar, Sicherheitsbarriere, Sicherheitsbarriere, Panel N Gam Junc and Panel S Gam Junc here.

Der Stationsalarm gibt ein ohrenbetäubenden Sirenenton von sich.

>d
Der Stationsalarm gibt ein ohrenbetäubenden Sirenenton von sich.

>d
Docking Bay
You can see Weltraumtür here.

Der Stationsalarm gibt ein ohrenbetäubenden Sirenenton von sich.

>d
You can't go that way.

>u
Hangar
You can see Luke_Hangar, Umkleidetür, Spind (empty) and Panel_Luke_H here.

Der Stationsalarm gibt ein ohrenbetäubenden Sirenenton von sich.

>u
Der Stationsalarm gibt ein ohrenbetäubenden Sirenenton von sich.

>u
Xeno Lab
You can see Luke_XenoLab and Percy here.

Der Stationsalarm gibt ein ohrenbetäubenden Sirenenton von sich.
Durch das Deckenfenster sieht man den grün glühenden  Maschinenkern.

* * *

>up
Hangar
You can see Luke_Hangar, Umkleidetür, Spind (in which are Mobitab and Sicherheitsausweis) and Panel_Luke_H here.

Der Stationsalarm gibt ein ohrenbetäubenden Sirenenton von sich.

>take sicherheitsausweis
Taken.

>use Sicherheitsausweis wiht Luke_Hangar
You can't see any such thing.

>use Sicherheitsausweis with Luke_Hangar
Du hast die Hangarluke für einen Zug geöffnet.

* * *

>up
Die Hangarluke schließt sich hinter dir.

Gamma Junction
You can see Luke_Hangar, Sicherheitsbarriere, Luke_XenoLab, Sicherheitsbarriere, Panel N Gam Junc and Panel S Gam Junc here.

Der Stationsalarm gibt ein ohrenbetäubenden Sirenenton von sich.

>up
(first opening Luke_XenoLab)

Xeno Lab
You can see Luke_XenoLab here.

Du spielst nun Barry!
Barry ist in Raumfähre
Szene 2Du bist Barry, nachdem du herausgefunden hast dass das Raumschiff einer aufwendigen Reparatur bedarf, wunderst du dich warum noch niemand gekommen ist und wo Percy seit dem Abholen der Palette abgeblieben ist. Du fängst an nach ihm zu suchen.

Der Stationsalarm gibt ein ohrenbetäubenden Sirenenton von sich.

>outside
Docking Bay
You can see Weltraumtür here.

Der Stationsalarm gibt ein ohrenbetäubenden Sirenenton von sich.

* * *

>up
Hangar
You can see Luke_Hangar, Umkleidetür, Spind (in which is Mobitab) and Panel_Luke_H here.

Der Stationsalarm gibt ein ohrenbetäubenden Sirenenton von sich.

>take Mobitab
Taken.

>use Mobitab with Panel_Luke_H
You can't see any such thing.

>hit Panel_Luke_H with Mobitab
Du hast das Panel kaputtgemacht. Jetzt kannst du über die Luke manuell öffnen oder schließen.

* * *

>undo
Gamma Junction
[Previous turn undone.]

>undo
Hangar
[Previous turn undone.]

>up
(first opening Luke_Hangar)
Der Stationsalarm gibt ein ohrenbetäubenden Sirenenton von sich.

* * *

>outside
You can't go that way.

Der Stationsalarm gibt ein ohrenbetäubenden Sirenenton von sich.
Durch das Deckenfenster sieht man den grün glühenden  Maschinenkern.

>wait
Time passes.

* * *

>wait
Time passes.

Du wurdest kontaminiert!

    *** The End ***

Would you like to RESTART, RESTORE a saved game, QUIT or UNDO the last command?

>restart
Lupus Station
An Interactive Fiction by Team14 Use MAX_STATIC_DATA of 100000000
Release 1 / Serial number 180624 / Inform 7 build 6M62 (I6/v6.33 lib 6/12N) SD

Raumfähre
You can see Barry here.

>wait
Time passes.

* * *

>outside
You can't go that way.

Der Stationsalarm gibt ein ohrenbetäubenden Sirenenton von sich.
Durch das Deckenfenster sieht man den grün glühenden  Maschinenkern.

>wiat
That's not a verb I recognise.

>wait
Time passes.

* * *

>wait
Time passes.

Du wurdest kontaminiert!

    *** The End ***

Would you like to RESTART, RESTORE a saved game, QUIT or UNDO the last command?

>wait
Please give one of the answers above.

Would you like to RESTART, RESTORE a saved game, QUIT or UNDO the last command?

* * *

Lupus Station
An Interactive Fiction by Team14 Use MAX_STATIC_DATA of 100000000
Release 1 / Serial number 180626 / Inform 7 build 6M62 (I6/v6.33 lib 6/12N) SD

Dekontaminationskabine
You can see Dekon Tür and Percy here.

>take Barry
I don't suppose Barry would care for that.

>o
Sorry, that can't be corrected.

* * *

>outside
Docking Bay
You can see Weltraumtür here.

Der Stationsalarm gibt ein ohrenbetäubenden Sirenenton von sich.

>i
You are carrying nothing.

>inside
Raumfähre
You can see Barry here.

Der Stationsalarm gibt ein ohrenbetäubenden Sirenenton von sich.

* * *

Lupus Station
An Interactive Fiction by Team14 Use MAX_STATIC_DATA of 100000000
Release 1 / Serial number 180626 / Inform 7 build 6M62 (I6/v6.33 lib 6/12N) SD

Dekontaminationskabine
You can see Dekon Tür and Percy here.

>talk with Barry
That noun did not make sense in this context.

* * *

Lupus Station
An Interactive Fiction by Team14 Use MAX_STATIC_DATA of 100000000
Release 1 / Serial number 180626 / Inform 7 build 6M62 (I6/v6.33 lib 6/12N) SD

Dekontaminationskabine
You can see Dekon Tür and Percy here.

>wait
Time passes.

yourself0

>wait
Time passes.

yourself0

>wait
Time passes.

yourself0Du wurdest kontaminiert!

    *** The End ***

Would you like to RESTART, RESTORE a saved game, QUIT or UNDO the last command?