Szene 1:
Percy fliegt die Fähre, Barry übernimmt die Kommunikation. Als sie sich der Station nähern wundern sie sich, dass zwar der automatische Leitstrahl funktioniert, sie jedoch keine Antwort auf ihre Landeanfrage erhalten. Da der Leitstrahl sie führt und das automatische Andocken einleitet, denken sie sich nichts weiter und halten das für ein eventuelles Willkommensritual des Außenpostens. Ein knarrendes Geräusch beim Einflug in die DockingBay la¨sst aber nichts Gutes ahnen. Als sie aus der Fähre aussteigen, finden sie den Dock- und Hangarbereich verlassen vor. Sie sind verwundert und einigen sich darauf, dass Barry die Fähre äußerlich bzgl. des entstandenen Schadens untersucht. Du spielst Percy und machst dich auf, um nach dem Stationspersonal suchen und um dich auf der Brücke beim wachhabenden Offizier meldet. Besuche zunächst einmal das Xeno-Lab.
Ein Tipp: Finde den Laborkittel!
Lupus Station
An Interactive Fiction by Team14 Use MAX_STATIC_DATA of 100000000
Release 1 / Serial number 180703 / Inform 7 build 6M62 (I6/v6.33 lib 6/12N) SD

Raumfähre
You can see Palette, Barry and Antigravitationsgreifer here.

I beg your pardon?

* * *

>Take Palette
Das ist viel zu schwer... Du müsstest den Antigravitationsgreifer anbringen damit du sie bewegen kannst.

Der Stationsalarm gibt ein ohrenbetäubenden Sirenenton von sich.

>inv
You are carrying:
  Messenger

>drop Messenger
Der Messenger ist Teil deiner Ausrüstung! Diesen kannst du nicht wegwerfen!

>use Drcuklufthammer
You can't see any such thing.

>use Drucklufthammer
You can't see any such thing.

>teleport to Hangar
Hangar
You can see Luke_Hangar, Umkleidetür, Spind (in which are Mobitab and Sicherheitsausweis), Drucklufthammer and Panel U Hangar here.

Der Stationsalarm gibt ein ohrenbetäubenden Sirenenton von sich.

>use Drucklufthammer
Du hast den Drucklufthammer nicht bei dir.

>take Drucklufthammer
Du brauchst das noch nicht.

>Take Palette
You can't see any such thing.

>d
Docking Bay
You can see Weltraumtür here.

Der Stationsalarm gibt ein ohrenbetäubenden Sirenenton von sich.

>in
Raumfähre
You can see Palette and Barry here.

Der Stationsalarm gibt ein ohrenbetäubenden Sirenenton von sich.

>take Palette
Das ist viel zu schwer... Du müsstest den Antigravitationsgreifer anbringen damit du sie bewegen kannst.

>push Palette
Nothing obvious happens.

>push Palette outisde
You can't see any such thing.

>push Palette outside
Palette cannot be pushed from place to place.

* * *

>clap in Hands
Du hast in die Hände geklatscht doch der Stationsalarm ist zu laut!

I beg your pardon?

I beg your pardon?

>s
Beta Juncton

>s
Gamma Beta Corridor

>n
Beta Juncton

>n
Alpha Beta Corridor
You can see Kontaminierter here.

>clap in Hands
Du hast in die Hände geklatscht!

>d
You can't go that way.

>d
You can't go that way.

>clap in Hands
Du hast in die Hände geklatscht!

>n
Alpha Junction
You can see Kontaminierter here.

>n
Alpha Delta Corridor
You can see Kontaminierter here.

>n
Delta Junction

>s
Alpha Delta Corridor
You can see Kontaminierter here.

>clap in Hands
Du hast in die Hände geklatscht!

>clap in Hands
Du hast in die Hände geklatscht!

>n
Delta Junction

>n
Gamma Delta Junction

>s
Delta Junction

>s
Alpha Delta Corridor
You can see Kontaminierter here.

* * *

>clap in Hands
Du hast in die Hände geklatscht!

>n
Delta Junction
You can see Kontaminierter here.

>n
Gamma Delta Junction

* * *

>clap in Hands
Du hast in die Hände geklatscht doch der Stationsalarm ist zu laut!

>clap in Hands
Du hast in die Hände geklatscht!

>clap in Hands
Du hast in die Hände geklatscht!

Du wurdest kontaminiert

    *** The End ***

Would you like to RESTART, RESTORE a saved game, QUIT or UNDO the last command?

* * *

>close Dekon Tür
TEMP muss noch geschrieben werden!
You close Dekon Tür.

Der Stationsalarm gibt ein ohrenbetäubenden Sirenenton von sich.
Durch das Deckenfenster sieht man den orange glühenden Maschinenkern.

>open Dekon Tür
You open Dekon Tür.

>close Dekon Tür
TEMP muss noch geschrieben werden!
You close Dekon Tür.

Du wurdest kontaminiert!

    *** The End ***

Would you like to RESTART, RESTORE a saved game, QUIT or UNDO the last command?

>restart
Lupus Station
An Interactive Fiction by Team14 Use MAX_STATIC_DATA of 100000000
Release 1 / Serial number 180627 / Inform 7 build 6M62 (I6/v6.33 lib 6/12N) SD

Med Lab
You can see Dekon Tür, Luke_MedLab, Kontaminierter and Med-Lab Pult here.

* * *

>open Dekon Tür
You open Dekon Tür.

>inside
Dekontaminationskabine
You can see Dekon Tür and Percy here.

Der Stationsalarm gibt ein ohrenbetäubenden Sirenenton von sich.
Durch das Deckenfenster sieht man den orange glühenden Maschinenkern.

>wait
Time passes.

>wait
Time passes.

* * *

>connect Gravitationsgreifer with Palette
Du trägst nicht den Gravitationsgreifer!

Der Stationsalarm gibt ein ohrenbetäubenden Sirenenton von sich.

>take Gravitationsgreifer
Taken.

>connect Gravitationsgreifer with Palette
Du hast den Greifer an die Palette angebracht.

>look
Raumfähre
You can see Palette and Barry here.

* * *

>d
Hangar
You can see Umkleidetür here.

Der Stationsalarm gibt ein ohrenbetäubenden Sirenenton von sich.

>d
Docking Bay
Der Stationsalarm gibt ein ohrenbetäubenden Sirenenton von sich.

>u
Hangar
Der Stationsalarm gibt ein ohrenbetäubenden Sirenenton von sich.

>look
Hangar

>d
Docking Bay
Der Stationsalarm gibt ein ohrenbetäubenden Sirenenton von sich.

>look
Docking Bay

>look
Docking Bay

>w
You can't go that way.

>w
You can't go that way.

>e
You can't go that way.

>e
You can't go that way.

* * *

>u
Hangar
Der Stationsalarm gibt ein ohrenbetäubenden Sirenenton von sich.

>u
Gamma Junction
You can see Deckenluke, Sicherheitsbarriere, Sicherheitsbarriere, Mobitab and Panel Norden here.

>d
Hangar

>d
Docking Bay

>i
You are carrying nothing.

>go inside
Raumfähre

>out
Docking Bay

>in
Raumfähre

>out
Docking Bay

>u
Hangar

>u
Gamma Junction
You can see Deckenluke, Sicherheitsbarriere, Sicherheitsbarriere, Mobitab and Panel Norden here.

>up
(first opening Deckenluke)
It seems to be locked.

>d
Hangar

>west
You can't go that way.

>up
Gamma Junction
You can see Deckenluke, Sicherheitsbarriere, Sicherheitsbarriere, Mobitab and Panel Norden here.

>west
You can't go that way.

>east
Storage Area

>east
You can't go that way.

* * *

>d
Hangar
You can see Umkleidetür here.

Der Stationsalarm gibt ein ohrenbetäubenden Sirenenton von sich.

>go inside
(first opening Umkleidetür)
It seems to be locked.

* * *

>d
Hangar
You can see Umkleidetür here.

Der Stationsalarm gibt ein ohrenbetäubenden Sirenenton von sich.

>u
Gamma Junction
You can see Deckenluke, Sicherheitsbarriere, Sicherheitsbarriere, Mobitab and Panel Norden here.

>w
You can't go that way.

>e
You can't go that way.

Du wurdest kontaminiert!

    *** The End ***

Would you like to RESTART, RESTORE a saved game, QUIT or UNDO the last command?

* * *

>e
Storage Area
Der Stationsalarm gibt ein ohrenbetäubenden Sirenenton von sich.

>w
Gamma Junction
You can see Deckenluke, Sicherheitsbarriere, Sicherheitsbarriere, Mobitab and Panel Norden here.

Der Stationsalarm gibt ein ohrenbetäubenden Sirenenton von sich.

>e
Storage Area
Der Stationsalarm gibt ein ohrenbetäubenden Sirenenton von sich.

>d
You can't go that way.

Der Stationsalarm gibt ein ohrenbetäubenden Sirenenton von sich.

>w
Gamma Junction
You can see Deckenluke, Sicherheitsbarriere, Sicherheitsbarriere, Mobitab and Panel Norden here.

Der Stationsalarm gibt ein ohrenbetäubenden Sirenenton von sich.

>d
Hangar
Der Stationsalarm gibt ein ohrenbetäubenden Sirenenton von sich.

>d
Docking Bay
Der Stationsalarm gibt ein ohrenbetäubenden Sirenenton von sich.

* * *

>u
Hangar
Der Stationsalarm gibt ein ohrenbetäubenden Sirenenton von sich.

>u
Gamma Junction
You can see Deckenluke, Sicherheitsbarriere, Sicherheitsbarriere, Mobitab and Panel Norden here.

Der Stationsalarm gibt ein ohrenbetäubenden Sirenenton von sich.

>d
Hangar
Der Stationsalarm gibt ein ohrenbetäubenden Sirenenton von sich.

* * *

>d
Docking Bay
Der Stationsalarm gibt ein ohrenbetäubenden Sirenenton von sich.

>n
You can't go that way.

Der Stationsalarm gibt ein ohrenbetäubenden Sirenenton von sich.

>n
You can't go that way.

Der Stationsalarm gibt ein ohrenbetäubenden Sirenenton von sich.

>u
Hangar
Der Stationsalarm gibt ein ohrenbetäubenden Sirenenton von sich.

* * *

>u
Gamma Junction
You can see Deckenluke, Sicherheitsbarriere, Sicherheitsbarriere, Mobitab and Panel Norden here.

Der Stationsalarm gibt ein ohrenbetäubenden Sirenenton von sich.

>n
(first opening Sicherheitsbarriere)
It seems to be locked.

Der Stationsalarm gibt ein ohrenbetäubenden Sirenenton von sich.

>n
(first opening Sicherheitsbarriere)
It seems to be locked.

Der Stationsalarm gibt ein ohrenbetäubenden Sirenenton von sich.

* * *

>e
Storage Area
Der Stationsalarm gibt ein ohrenbetäubenden Sirenenton von sich.

>we
That's not a verb I recognise.

>e
You can't go that way.

>w
Gamma Junction
You can see Deckenluke, Sicherheitsbarriere, Sicherheitsbarriere, Mobitab and Panel Norden here.

>e
Storage Area

>we
That's not a verb I recognise.

* * *

>w
Gamma Junction
You can see Deckenluke, Sicherheitsbarriere, Sicherheitsbarriere, Mobitab and Panel Norden here.

>sw
You can't go that way.

>se
You can't go that way.

>nw
You can't go that way.

>ne
You can't go that way.

>s
(first opening Sicherheitsbarriere)
It seems to be locked.

>s
(first opening Sicherheitsbarriere)
It seems to be locked.

>e
Storage Area

>d
You can't go that way.

>u
Delta AI

>d
Storage Area

* * *

>go down
Xeno Lab

>go up
Gamma Junction

>go up
Hangar

>go up
Docking Bay

>go inside
You can't go that way.

>go down
Hangar

>go inside
Raumfähre

>go outside
Hangar

>go up
Docking Bay

>go south
Weltraum

>go south
Com Base

>go down
Wartungsschacht

>go down
Gamma Delta Junction.

>go north
Gamma Junction

>go north
Gamma Beta Corridor

>go north
Beta Juncton

>go down
Engeneering Lab

>go up
Beta Juncton

>go north
Alpha Beta Corridor

>go north
Alpha Junction

>go down
Med Lab

>go up
Alpha Junction

>go up
Duty Room

>go up
Crew Quarter

>go down
Duty Room

>go down
Alpha Junction

>go north
Alpha Delta Corridor

>go north
Delta Junction

>go down
Solar Lab

>go up
Delta Junction

>go north
Gamma Delta Junction.

* * *

>go east
Storage Area
0  0

>go north
Beta Greenhouse

>go south
Storage Area

>go down
Delta AI

>go south
Main Generator

>go north
Delta AI

>go up
Storage Area

>go west
Gamma Junction

>go north
Gamma Beta Corridor

* * *

>go north
Beta Juncton

>go north
Alpha Beta Corridor

* * *

>go north
Alpha Junction

>go up
Duty Room

>go east
Cafeteria

>go up
You can't go that way.

>go down
Storage Room

>go suth
You can't see any such thing.

>go south
You can't go that way.

>go north
Delta Greenhouse

>go south
Storage Room

>go down
Alpha AI

>go south
Transporter Raum

>go north
Alpha AI

>go up
Storage Room

>go up
Cafeteria

>go west
Duty Room

>go up
Crew Quarter

>go east
Fitness

>go west
Crew Quarter

>go down
Duty Room

>go west
Briefing Room

>go up
Bridge

>go down
Briefing Room

>go east
Duty Room

>go down
Alpha Junction

* * *

>go north
Delta Junction

>go north
Gamma Delta Junction.

>go north
Gamma Junction

>go south
Gamma Delta Junction.

>go up
Wartungsschacht

>go up
Com Base

>go east
Second Generator

>go west
Com Base

>go west
Antenna Array

* * *

>go east
Storage Area
0  0

>go west
Gamma Junction
You can see Tür1 here.

0  0

>go up
Xeno Lab
0  0

>go down
Gamma Junction
You can see Tür1 here.

0  0

>go down
Hangar
0  0

>go inside
Umkliedekabine
0  0

* * *

>go noerth
You can't see any such thing.

>go north
Gamma Beta Corridor

* * *

>go north
Alpha Junction

>go north
You can't go that way.

>go south
Alpha Beta Corridor

>go north
Alpha Junction

* * *

>go north
(first opening Sicherheitsbarriere)
It seems to be locked.

>go north
Beta Junction

>go north
Alpha Beta Corridor
You can see Kontaminierter here.

>go north
0  0

>go north
0  0

>go north
Gamma Delta Junction.

* * *

>go north
0  0

>look
Delta Junction
0  0

>look
Delta Junction
0  0

>s
0  0

>s
0  0

>look
Alpha Beta Corridor
You can see Kontaminierter here.

0  1

>look
Alpha Beta Corridor
You can see Kontaminierter here.

0  2
Du wurdest kontaminiert!

    *** The End ***

Would you like to RESTART, RESTORE a saved game, QUIT or UNDO the last command?

>restart
Lupus Station
An Interactive Fiction by Team14 Use MAX_STATIC_DATA of 100000000
Release 1 / Serial number 180516 / Inform 7 build 6M62 (I6/v6.33 lib 6/12N) SD

Gamma Junction
You can see Tür1 here.

0  0

>look
Gamma Junction
You can see Tür1 here.

0  0

>n
0  0

>llok
That's not a verb I recognise.

>look
Gamma Beta Corridor
0  0

>n
0  0

>look
Beta Juncton
0  0

>n
0  0

>look
Alpha Beta Corridor
You can see Kontaminierter here.

0  1

>take
(Kontaminierter)
That's fixed in place.

Du wurdest kontaminiert!

    *** The End ***

Would you like to RESTART, RESTORE a saved game, QUIT or UNDO the last command?

* * *

>go north
0  0

>transp
nicht möglich!

>transp
nicht möglich!

>go north
Alpha Delta Corridor

>go south
Alpha Junction

>go up
Duty Room

* * *

>go east
Cafeteria

>go down
Storage Room

>go down
Alpha AI

* * *

>go south
Transporter Raum

>transp
Transporter Module

* * *

>go north
Alpha Beta Corridor
You can see Kontaminierter here.

>take
(Kontaminierter)
That's fixed in place.

0  1

>take
(Kontaminierter)
That's fixed in place.

0  2

>go north
Alpha Junction
0  0

>look
Alpha Junction
0  0

>s
Alpha Beta Corridor
You can see Kontaminierter here.

0  0

>clap in hands
Du hast in die Hände geklatscht!

1  1

>take
(Kontaminierter)
That's fixed in place.

2  2

>n
Alpha Junction
You can see Kontaminierter here.

1  0

>take
(Kontaminierter)
That's fixed in place.

2  1

* * *

>go north
Alpha Beta Corridor
You can see Kontaminierter here.

>talk with Kontaminierter
Du hast den Kontaminierten angesprochen.

1  1

>talk with Kontaminierter
Du hast den Kontaminierten angesprochen.

2  2

>s
Beta Juncton
You can see Kontaminierter here.

0  0

>n
Alpha Beta Corridor
0  0

>s
Beta Juncton
You can see Kontaminierter here.

0  0

>talk with Kont
That noun did not make sense in this context.

>talk with Table
That noun did not make sense in this context.

>talk with Kontaminierter
Du hast den Kontaminierten angesprochen.

1  1

>s
Gamma Beta Corridor
0  0

>s
Gamma Junction
You can see Tür1 here.

0  0

>talk with Tür1
That noun did not make sense in this context.

>n
Gamma Beta Corridor
0  0

>n
Beta Juncton
You can see Kontaminierter here.

0  0

>n
Alpha Beta Corridor
0  0

* * *

>s
Beta Juncton
You can see Kontaminierter here.

0  0

>clap in hands
Du hast in die Hände geklatscht!

1  1

* * *

>take
(Kontaminierter)
That's fixed in place.

2  2

>take
(Kontaminierter)
That's fixed in place.

Du wurdest kontaminiert!
3  3

    *** The End ***

Would you like to RESTART, RESTORE a saved game, QUIT or UNDO the last command?

>restart
Lupus Station
An Interactive Fiction by Team14 Use MAX_STATIC_DATA of 100000000
Release 1 / Serial number 180516 / Inform 7 build 6M62 (I6/v6.33 lib 6/12N) SD

Gamma Junction
You can see Tür1 here.

>n
Gamma Beta Corridor
0  0

>n
Beta Juncton
0  0

>n
Alpha Beta Corridor
You can see Kontaminierter here.

0  0

>clap in hands
Du hast in die Hände geklatscht!

1  1

>wait
Time passes.

2  2

I beg your pardon?

>s
Beta Juncton
You can see Kontaminierter here.

0  0

* * *

>go north
Alpha Beta Corridor
You can see Kontaminierter here.

>wait
Time passes.

>clap in hands
Du hast in die Hände geklatscht!

>n
Alpha Junction

>s
Alpha Beta Corridor
You can see Kontaminierter here.

>wait
Time passes.

* * *

>clap in hands
Du hast in die Hände geklatscht!

>clap in hands
Du hast in die Hände geklatscht!

Du wurdest kontaminiert!

    *** The End ***

Would you like to RESTART, RESTORE a saved game, QUIT or UNDO the last command?

>retsart
Please give one of the answers above.

Would you like to RESTART, RESTORE a saved game, QUIT or UNDO the last command?

>retstart
Please give one of the answers above.

Would you like to RESTART, RESTORE a saved game, QUIT or UNDO the last command?

>restart
Lupus Station
An Interactive Fiction by Team14 Use MAX_STATIC_DATA of 100000000
Release 1 / Serial number 180516 / Inform 7 build 6M62 (I6/v6.33 lib 6/12N) SD

Gamma Junction
You can see Tür1 here.

>n
Gamma Beta Corridor

>n
Beta Junction

>n
Alpha Beta Corridor
You can see Kontaminierter here.

>clap in hands
Du hast in die Hände geklatscht!

>clap in hands
Du hast in die Hände geklatscht!

>n
Alpha Junction
You can see Kontaminierter here.

* * *

>go north
(first opening Sicherheitsbarriere)
It seems to be locked.

>look
Gamma Beta Corridor
0  0

>go north
Beta Juncton
0  0

>look
Beta Juncton
0  0

>go north
Alpha Beta Corridor
You can see Kontaminierter here.

0  1

>k
That's not a verb I recognise.

>k
That's not a verb I recognise.

>look
Alpha Beta Corridor
You can see Kontaminierter here.

0  2

>look
Alpha Beta Corridor
You can see Kontaminierter here.

Du wurdest kontaminiert!
0  3

    *** The End ***

Would you like to RESTART, RESTORE a saved game, QUIT or UNDO the last command?

* * *

>go north
(first opening Sicherheitsbarriere)
It seems to be locked.

>take MobiTab
Taken.

* * *

>go northh
You can't see any such thing.

>go north
0  0

>go north
0  1

>take
(Kontaminierter)
That's fixed in place.

>take
(Kontaminierter)
That's fixed in place.

>go east
You can't go that way.

>go east
You can't go that way.

* * *

>go oustide
You can't see any such thing.

>go up
You can't go that way.

Der Stationsalarm gibt ein ohrenbetäubenden Sirenenton von sich.

>take sicherheitsausweis from spind
You can't see any such thing.

>use sicherheitsausweis with lupanel
You can't see any such thing.

>use sicherheitsausweis with lupanel u
You can't see any such thing.

>use sicherheitsausweis with lupanel u hangar
You can't see any such thing.

>go outside
Docking Bay
You can see Weltraumtür here.

Der Stationsalarm gibt ein ohrenbetäubenden Sirenenton von sich.

>go up
Hangar
You can see Luke_Hangar, Umkleidetür, Spind (in which are Mobitab and Sicherheitsausweis), Drucklufthammer and LuPanel U Hangar here.

Der Stationsalarm gibt ein ohrenbetäubenden Sirenenton von sich.

>take sicherheitsausweis from spind
Taken.

>use sicherheitsausweis with lupanel
Du hast die Hangarluke für einen Zug geöffnet.

>go up
Gamma Junction
Im Boden ist ein riesiges Bodenfenster eingelassen. Es sieht gar nicht mal so stabil aus.

You can see Luke_Hangar, Sicherheitsbarriere, Luke_XenoLab, Sicherheitsbarriere, Panel N Gam Junc, Panel S Gam Junc, LuPanel U Gam Junc and LuPanel D Gam Junc here.

Der Stationsalarm gibt ein ohrenbetäubenden Sirenenton von sich.

Die Hangarluke hat sich geschlossen!

>use sicherheitsausweis with panel s
(Panel S Gam Junc)
Du hast die zugehörige Tür des Panels entriegelt.

>go south
Gamma Delta Junction
You can see Sicherheitsbarriere, Sicherheitsbarriere, Wartungsluke, Oeffnungshebel, Leiche (on which is Laborkittel), Panel N Gam Del Cor and Panel S Gam Del Cor here.

Der Stationsalarm gibt ein ohrenbetäubenden Sirenenton von sich.

>go down
(first opening Wartungsluke)
It seems to be locked.

* * *

>go up
You can't go that way.

>go down
Gamma Junction

>go down
Hangar

>go up
Gamma Junction

>go up
Xeno Lab
You can see Adam here.

>go up
You can't go that way.

>go up
You can't go that way.

>go up
You can't go that way.

ok

>go down
Gamma Junction
ok

>go down
Hangar
ok

* * *

>interact with Med-Lab
You can't see any such thing.

>interact with Med-Lab Pult
You can't see any such thing.

* * *

>d
Der Alarm der Station gibt ein ohrenbetäubenden Sirenenton von sich.

(first opening Deckenluke)
It seems to be locked.

>d
Der Alarm der Station gibt ein ohrenbetäubenden Sirenenton von sich.

(first opening Deckenluke)
It seems to be locked.

>u
You can't go that way.

>u
You can't go that way.

>wait
Time passes.

Du wurdest kontaminiert!

    *** The End ***

Would you like to RESTART, RESTORE a saved game, QUIT or UNDO the last command?

* * *

>interact with Med-Lab_Pult
TEMP muss noch geschrieben werden!!!

>wait
Time passes.

>wait
Time passes.

Du wurdest kontaminiert!

    *** The End ***

Would you like to RESTART, RESTORE a saved game, QUIT or UNDO the last command?

>undo
Med Lab
[Previous turn undone.]

>undo
Med Lab
[Previous turn undone.]

>undo
You can't "undo" what hasn't been done!

>wait
Time passes.

* * *

>n
(first opening Sicherheitsbarriere)
It seems to be locked.

>n
Beta Junction

* * *

>s
Alpha Beta Corridor
You can see Kontaminierter here.

>clap in hands
Du hast in die Hände geklatscht!

* * *

>n
Alpha Junction
You can see Kontaminierter here.

>clap in hands
Du hast in die Hände geklatscht!

>wait
Time passes.

Du wurdest kontaminiert!

    *** The End ***

Would you like to RESTART, RESTORE a saved game, QUIT or UNDO the last command?

* * *

>n
Alpha Beta Corridor
You can see Kontaminierter here.

>talk with Kontaminier
Du hast den Kontaminierten angesprochen.

>wait
Time passes.

>s
Beta Juncton
You can see Kontaminierter here.

* * *

>n
(first opening Sicherheitsbarriere)
It seems to be locked.

>u
Der Alarm der Station gibt ein Ohrenbetäubenden Sirenenton von sich.

>s
You can't go that way.

>d
Der Alarm der Station gibt ein Ohrenbetäubenden Sirenenton von sich.

>d
Der Alarm der Station gibt ein Ohrenbetäubenden Sirenenton von sich.

>d
You can't go that way.

* * *

>out
Docking Bay
You can see Weltraumtür here.

Der Stationsalarm gibt ein ohrenbetäubenden Sirenenton von sich.

>up
Hangar
You can see Luke_Hangar, Umkleidetür, Spind (in which are Mobitab and Sicherheitsausweis), Drucklufthammer and LuPanel U Hangar here.

Der Stationsalarm gibt ein ohrenbetäubenden Sirenenton von sich.

>look at spind
Der Spind eines Deckoffiziers, wahrscheinlich in Eile offengelassen.

In Spind are Mobitab and Sicherheitsausweis.

>enter spind
That's not something you can enter.

>take spind
That's fixed in place.

>down
Docking Bay
You can see Weltraumtür here.

Der Stationsalarm gibt ein ohrenbetäubenden Sirenenton von sich.

>place spind
That's not a verb I recognise.

>drop spind
You can't see any such thing.

>look
Docking Bay
You can see Weltraumtür here.

>up
Hangar
You can see Luke_Hangar, Umkleidetür, Spind (in which are Mobitab and Sicherheitsausweis), Drucklufthammer and Panel_Luke_H here.

Der Stationsalarm gibt ein ohrenbetäubenden Sirenenton von sich.

>close spind
It isn't something you can close.

>lock spind
(with Messenger)
That doesn't seem to be something you can lock.

>inv
You are carrying:
  Messenger

* * *

>up
Hangar
You can see Luke_Hangar, Umkleidetür, Spind (in which are Mobitab and Sicherheitsausweis), Drucklufthammer and LuPanel U Hangar here.

Der Stationsalarm gibt ein ohrenbetäubenden Sirenenton von sich.

>take Drucklufthammer
Du brauchst das noch nicht.

>teleport to Gamma_Junction
Gamma Junction
You can see Luke_Hangar, Sicherheitsbarriere, Luke_XenoLab, Sicherheitsbarriere, Panel N Gam Junc, Panel S Gam Junc, Panel U Gam Junc and Panel D Gam Junc here.

Der Stationsalarm gibt ein ohrenbetäubenden Sirenenton von sich.

>use Drucklufthammer
Du hast den Drucklufthammer benutzt und ein lautes Geräusch gemacht.

>use Drucklufthammer
Der Drucklufthammer hat keine Energie. Du musst ihn an einem Panel (N oder S) aufladen

>charge Drucklufthammer with Panel N Gam Junc
Du hast den Drucklufthammer aufgeladen.

>charge Drucklufthammer with Panel N Gam Junc
Der Drucklufthammer ist schon geladen!

>use Drucklufthammer
Du hast den Drucklufthammer benutzt und ein lautes Geräusch gemacht.

>charge Drucklufthammer with Panel N Gam Junc
Du hast den Drucklufthammer aufgeladen.

>use Drucklufthammer
Du hast den Drucklufthammer benutzt und ein lautes Geräusch gemacht.

* * *

>take Drucklufthammer
Du brauchst das noch nicht.

>use Drucklufthammer
Du hast den Drucklufthammer nicht bei dir.

>charge Drucklufthammer with LuPanel U Hangar
That noun did not make sense in this context.

>take Sicherheitsausweis
Taken.

* * *

>up
Hangar
You can see Luke_Hangar, Umkleidetür, Spind (in which are Mobitab and Sicherheitsausweis), Drucklufthammer and LuPanel U Hangar here.

Der Stationsalarm gibt ein ohrenbetäubenden Sirenenton von sich.

>take Mobitab
Du traust dir das nicht zu, das zu nehmen.

>take Sicherheitsausweis
Taken.

>tust
Du spielst nun Barry!
Barry ist in Raumfähre

Du spielst nun Percy!
Percy ist in Hangar

>out
But you aren't in anything at the moment.

>up
(first opening Luke_Hangar)
It seems to be locked.

>take Percy
You can't see any such thing.

>d
Docking Bay
You can see Weltraumtür here.

Der Stationsalarm gibt ein ohrenbetäubenden Sirenenton von sich.

>u
Hangar
You can see Sicherheitsausweis, Luke_Hangar, Umkleidetür, Spind (in which is Mobitab), Drucklufthammer and Panel_Luke_H here.

Der Stationsalarm gibt ein ohrenbetäubenden Sirenenton von sich.

>wait
Time passes.

>udno
That's not a verb I recognise.

>undo
Hangar
[Previous turn undone.]

>undo
Hangar
[Previous turn undone.]

>undo
Docking Bay
[Previous turn undone.]

>look
Docking Bay
You can see Weltraumtür here.

* * *

>up
Hangar
You can see Luke_Hangar, Umkleidetür, Spind (in which are Mobitab and Sicherheitsausweis), Drucklufthammer and LuPanel U Hangar here.

Der Stationsalarm gibt ein ohrenbetäubenden Sirenenton von sich.

>take Sicherheitsausweis
Taken.

>tust
That's not a verb I recognise.

>inv
You are carrying:
  Sicherheitsausweis
  Messenger

>look
Hangar
You can see Luke_Hangar, Umkleidetür, Spind (in which is Mobitab), Drucklufthammer and Panel_Luke_H here.

>take Panel_Luke_H
That's fixed in place.

* * *

>take Sicherheitsausweis
Taken.

>use Sicherheitsausweis with LuPanel U Hangar
Du hast die Hangarluke für einen Zug geöffnet.

>up
Gamma Junction
Im Boden ist ein riesiges Bodenfenster eingelassen. Es sieht gar nicht mal so stabil aus.

You can see Luke_Hangar, Sicherheitsbarriere, Luke_XenoLab, Sicherheitsbarriere, Panel N Gam Junc, Panel S Gam Junc, LuPanel U Gam Junc and LuPanel D Gam Junc here.

Der Stationsalarm gibt ein ohrenbetäubenden Sirenenton von sich.

Die Hangarluke hat sich geschlossen!

>use Sicherheitsausweis with Panel N Del Junc
You can't reach into Delta Junction.

>use Sicherheitsausweis with Panel N Gam Junc
Du hast die zugehörige Tür des Panels entriegelt.

>n
Gamma Beta Corridor
You can see Sicherheitsbarriere, Sicherheitsbarriere, Panel N Gam Bet Cor and Panel S Gam Bet Cor here.

Der Stationsalarm gibt ein ohrenbetäubenden Sirenenton von sich.

>use Sicherheitsausweis with Panel N Gam Bet Cor
Du hast die zugehörige Tür des Panels entriegelt.

>n
Beta Junction
You can see Sicherheitsbarriere, Luke_Engineering, Sicherheitsbarriere, Panel N Bet Junc, Panel S Bet Junc and LuPanel U Bet Junc here.

Der Stationsalarm gibt ein ohrenbetäubenden Sirenenton von sich.

>use Sicherheitsausweis with Panel N Bet Junc
Du hast die zugehörige Tür des Panels entriegelt.

>n
Alpha Beta Corridor
You can see Sicherheitsbarriere, Sicherheitsbarriere, Kontaminierter, Panel N Alp Bet Cor and Panel S Alp Bet Cor here.

Der Stationsalarm gibt ein ohrenbetäubenden Sirenenton von sich.

>use Sicherheitsausweis with Panel N Alp Bet Cor
Du hast die zugehörige Tür des Panels entriegelt.

>n
Alpha Junction
You can see Sicherheitsbarriere, Luke_MedLab, Sicherheitsbarriere, Panel N Alp Junc, Panel S Alp Junc and LuPanel U Alp Junc here.

Der Stationsalarm gibt ein ohrenbetäubenden Sirenenton von sich.

>use Sicherheitsausweis with Panel N Alp Junc
Du hast die zugehörige Tür des Panels entriegelt.

>n
Alpha Delta Corridor
You can see Sicherheitsbarriere, Sicherheitsbarriere, Kontaminierter, Panel N Alp Del Cor and Panel S Alp Del Cor here.

Der Stationsalarm gibt ein ohrenbetäubenden Sirenenton von sich.

>use Sicherheitsausweis with Panel N Alp Del Cor
Du hast die zugehörige Tür des Panels entriegelt.

>n
Delta Junction
You can see Sicherheitsbarriere, Luke_SolarLab, Sicherheitsbarriere, Panel N Del Junc, Panel S Del Junc and LuPanel U Del Junc here.

Der Stationsalarm gibt ein ohrenbetäubenden Sirenenton von sich.

>use Sicherheitsausweis with Panel N Del Junc
Du hast die zugehörige Tür des Panels entriegelt.

>n
Percy findet eine Leiche und an den Wänden Spuren von Handlaserwaffen. Außerdem stellt er fest, dass der Öffnungshebel für die Wartungsluke zum Kommunikationsmodul durch Laserfeuer abgetrennt worden ist. Der Öffnungshebel liegt nun auf dem Boden, so dass ein Öffnen der Luke von hier aus nicht möglich ist. Was ist hier passiert? In dem Laborkittel der Leiche, die offenbar ein Wissenschaftler gewesen war, ist ein Transponder eingenäht. Wenn Percy den Kittel der Leiche auszieht und ihn selbst anzieht, könnte er hiermit die entsprechende Luke öffnen.

Gamma Delta Corridor
You can see Sicherheitsbarriere, Sicherheitsbarriere, Wartungsluke, Oeffnungshebel, Leiche (on which is Laborkittel), Panel N Gam Del Cor and Panel S Gam Del Cor here.

Der Stationsalarm gibt ein ohrenbetäubenden Sirenenton von sich.

>n
(first opening Sicherheitsbarriere)
It seems to be locked.

>s
Delta Junction
You can see Sicherheitsbarriere, Sicherheitsbarriere, Luke_SolarLab, Panel N Del Junc, Panel S Del Junc and LuPanel U Del Junc here.

Der Stationsalarm gibt ein ohrenbetäubenden Sirenenton von sich.

>s
Alpha Delta Corridor
You can see Sicherheitsbarriere, Sicherheitsbarriere, Kontaminierter, Panel N Alp Del Cor and Panel S Alp Del Cor here.

Der Stationsalarm gibt ein ohrenbetäubenden Sirenenton von sich.

>n
Delta Junction
You can see Sicherheitsbarriere, Sicherheitsbarriere, Luke_SolarLab, Panel N Del Junc, Panel S Del Junc and LuPanel U Del Junc here.

Der Stationsalarm gibt ein ohrenbetäubenden Sirenenton von sich.

>n
Gamma Delta Corridor
You can see Sicherheitsbarriere, Sicherheitsbarriere, Wartungsluke, Oeffnungshebel, Leiche (on which is Laborkittel), Panel N Gam Del Cor and Panel S Gam Del Cor here.

Der Stationsalarm gibt ein ohrenbetäubenden Sirenenton von sich.

>use Sicherheitsausweis with Panel N Gam Del Cor
Du hast die zugehörige Tür des Panels entriegelt.

>n
Gamma Junction
Im Boden ist ein riesiges Bodenfenster eingelassen. Es sieht gar nicht mal so stabil aus.

You can see Sicherheitsbarriere, Sicherheitsbarriere, Luke_Hangar, Luke_XenoLab, Panel N Gam Junc, Panel S Gam Junc, LuPanel U Gam Junc and LuPanel D Gam Junc here.

Der Stationsalarm gibt ein ohrenbetäubenden Sirenenton von sich.

>s
Gamma Delta Corridor
You can see Sicherheitsbarriere, Sicherheitsbarriere, Wartungsluke, Oeffnungshebel, Leiche (on which is Laborkittel), Panel N Gam Del Cor and Panel S Gam Del Cor here.

Der Stationsalarm gibt ein ohrenbetäubenden Sirenenton von sich.

>take Laborkittel
Taken.

>wear Laborkittel
You put on Laborkittel.

>s
Delta Junction
You can see Sicherheitsbarriere, Sicherheitsbarriere, Luke_SolarLab, Panel N Del Junc, Panel S Del Junc and LuPanel U Del Junc here.

Der Stationsalarm gibt ein ohrenbetäubenden Sirenenton von sich.

>n
Gamma Delta Corridor
You can see Sicherheitsbarriere, Sicherheitsbarriere, Wartungsluke, Oeffnungshebel, Leiche, Panel N Gam Del Cor and Panel S Gam Del Cor here.

Der Stationsalarm gibt ein ohrenbetäubenden Sirenenton von sich.

>n
Gamma Junction
Im Boden ist ein riesiges Bodenfenster eingelassen. Es sieht gar nicht mal so stabil aus.

You can see Sicherheitsbarriere, Sicherheitsbarriere, Luke_Hangar, Luke_XenoLab, Panel N Gam Junc, Panel S Gam Junc, LuPanel U Gam Junc and LuPanel D Gam Junc here.

Der Stationsalarm gibt ein ohrenbetäubenden Sirenenton von sich.

>use Laborkittel with Luke_XenoLab
Du hast die XenoLab Luke für einen Zug geöffnet.

>up
Du traust dich nicht durch die Luke zu gehen, es würde Sinn machen sie mit etwas zu blockieren... wie zum Beispiel mit der Palette.

Die XenoLab Luke hat sich geschlossen

>up
(first opening Luke_XenoLab)
It seems to be locked.

>up
(first opening Luke_XenoLab)
It seems to be locked.

>uü
That's not a verb I recognise.

>wait
Time passes.

>down
(first opening Luke_Hangar)
It seems to be locked.

>use Sicherheisausweis with LuPanel D Gam Junc
Du hast die Hangarluke für einen Zug geöffnet.

>d
Hangar
You can see Luke_Hangar, Umkleidetür, Spind (in which is Mobitab), Drucklufthammer and LuPanel U Hangar here.

Der Stationsalarm gibt ein ohrenbetäubenden Sirenenton von sich.

Die Hangarluke hat sich geschlossen!

>d
Docking Bay
You can see Weltraumtür here.

Der Stationsalarm gibt ein ohrenbetäubenden Sirenenton von sich.

>in
Raumfähre
You can see Palette, Barry and Gravitationsgreifer here.

Der Stationsalarm gibt ein ohrenbetäubenden Sirenenton von sich.

>take Gravitations
Taken.

>connect Gravitationsgreifer with Palette
Du hast den Greifer an die Palette angebracht.

>push Palette
Jetzt ist die Palette in Docking Bay.

>out
Docking Bay
You can see Palette and Weltraumtür here.

Der Stationsalarm gibt ein ohrenbetäubenden Sirenenton von sich.

>push Palette
Jetzt ist die Palette in Raumfähre.

>in
Raumfähre
You can see Palette and Barry here.

Der Stationsalarm gibt ein ohrenbetäubenden Sirenenton von sich.

>push Palette
Jetzt ist die Palette in Docking Bay.

* * *

>out
Docking Bay
You can see Palette and Weltraumtür here.

Der Stationsalarm gibt ein ohrenbetäubenden Sirenenton von sich.

>push Palette
Jetzt ist die Palette in Hangar.

>up
Hangar
You can see Palette, Luke_Hangar, Umkleidetür, Spind (in which is Mobitab), Drucklufthammer and LuPanel U Hangar here.

Der Stationsalarm gibt ein ohrenbetäubenden Sirenenton von sich.

>use Sicherheitsausweis with LuPanel U Hangar
Du hast die Hangarluke für einen Zug geöffnet.

>push Palette
Jetzt ist die Palette in Docking Bay.

Die Hangarluke hat sich geschlossen!

>use Sicherheitsausweis with LuPanel U Hangar
Du hast die Hangarluke für einen Zug geöffnet.

>u
Gamma Junction
Im Boden ist ein riesiges Bodenfenster eingelassen. Es sieht gar nicht mal so stabil aus.

You can see Luke_Hangar, Sicherheitsbarriere, Sicherheitsbarriere, Luke_XenoLab, Panel N Gam Junc, Panel S Gam Junc, LuPanel U Gam Junc and LuPanel D Gam Junc here.

Der Stationsalarm gibt ein ohrenbetäubenden Sirenenton von sich.

Die Hangarluke hat sich geschlossen!

>use Sicherheitsausweis with Panel N Gam Junc
Du hast die zugehörige Tür des Panels verriegelt.

>use Sicherheitsausweis with Panel S Gam Junc
Du hast die zugehörige Tür des Panels verriegelt.

>use Laborkittel with Luke_XenoLab
Du hast die XenoLab Luke für einen Zug geöffnet.

>push Palette
You can't see any such thing.

>up
Du traust dich nicht durch die Luke zu gehen, es würde Sinn machen sie mit etwas zu blockieren... wie zum Beispiel mit der Palette.

Die XenoLab Luke hat sich geschlossen

>press XenoKnopf
You can't see any such thing.

>look
Gamma Junction
Im Boden ist ein riesiges Bodenfenster eingelassen. Es sieht gar nicht mal so stabil aus.

You can see Luke_Hangar, Sicherheitsbarriere, Sicherheitsbarriere, Luke_XenoLab, Panel N Gam Junc, Panel S Gam Junc, LuPanel U Gam Junc and LuPanel D Gam Junc here.

>take Phiole
You can't see any such thing.

>undo
Gamma Junction
[Previous turn undone.]

>undo
Gamma Junction
[Previous turn undone.]

>up
Du traust dich nicht durch die Luke zu gehen, es würde Sinn machen sie mit etwas zu blockieren... wie zum Beispiel mit der Palette.

Die XenoLab Luke hat sich geschlossen

>close Luke_XenoLab
That's already closed.

>down
(first opening Luke_Hangar)
It seems to be locked.

>up
(first opening Luke_XenoLab)
It seems to be locked.

>n
(first opening Sicherheitsbarriere)
It seems to be locked.

>use Sicherheitsausweis with Panel S Gam Junc
Du hast die zugehörige Tür des Panels entriegelt.

>use Sicherheitsausweis with Panel N Gam Junc
Du hast die zugehörige Tür des Panels entriegelt.

* * *

>n
Gamma Beta Corridor
You can see Sicherheitsbarriere, Sicherheitsbarriere, Panel N Gam Bet Cor and Panel S Gam Bet Cor here.

Der Stationsalarm gibt ein ohrenbetäubenden Sirenenton von sich.

>n
Beta Junction
You can see Sicherheitsbarriere, Sicherheitsbarriere, Luke_Engineering, Panel N Bet Junc, Panel S Bet Junc and LuPanel U Bet Junc here.

Der Stationsalarm gibt ein ohrenbetäubenden Sirenenton von sich.

>s
Gamma Beta Corridor
You can see Sicherheitsbarriere, Sicherheitsbarriere, Panel N Gam Bet Cor and Panel S Gam Bet Cor here.

Der Stationsalarm gibt ein ohrenbetäubenden Sirenenton von sich.

>s
Gamma Junction
Im Boden ist ein riesiges Bodenfenster eingelassen. Es sieht gar nicht mal so stabil aus.

You can see Sicherheitsbarriere, Luke_Hangar, Sicherheitsbarriere, Luke_XenoLab, Panel N Gam Junc, Panel S Gam Junc, LuPanel U Gam Junc and LuPanel D Gam Junc here.

Der Stationsalarm gibt ein ohrenbetäubenden Sirenenton von sich.

>s
Gamma Delta Corridor
You can see Sicherheitsbarriere, Sicherheitsbarriere, Wartungsluke, Oeffnungshebel, Leiche, Panel N Gam Del Cor and Panel S Gam Del Cor here.

Der Stationsalarm gibt ein ohrenbetäubenden Sirenenton von sich.

>down
Du kannst die Luke nicht öffnen. Der Hebel ist abbgebrochen.

(first opening Wartungsluke)
It seems to be locked.

>look at Wartungsluke
You see nothing special about Wartungsluke.

>look at Oeffungshebel
You can't see any such thing.

>look at Oeffnungshebel
Der Öffnungshebel der Wartungsluke. Dort wo er durch das Laserfeuer abgetrennt wurde sieht man noch Schmauchspuren.

I beg your pardon?

* * *

>up
Hangar
You can see Luke_Hangar, Umkleidetür, Spind (in which are Mobitab and Sicherheitsausweis), Drucklufthammer and LuPanel U Hangar here.

Der Stationsalarm gibt ein ohrenbetäubenden Sirenenton von sich.

>take sicherheitsausweis
Taken.

>use Sicherheitsausweis with Luke_hangar
Du hast die Hangarluke für einen Zug geöffnet.

>up
Gamma Junction
You can see Luke_Hangar, Sicherheitsbarriere, Luke_XenoLab, Sicherheitsbarriere, Mobitab, Panel N Gam Junc and Panel S Gam Junc here.

Der Stationsalarm gibt ein ohrenbetäubenden Sirenenton von sich.

>d
(first opening Luke_Hangar)
It seems to be locked.

>use Sicherheitsausweis with Luke_hangar
Du hast die Hangarluke für einen Zug geöffnet.

>wait
Time passes.

>d
(first opening Luke_Hangar)
It seems to be locked.

* * *

>up
Hangar
You can see Luke_Hangar, Umkleidetür, Spind (in which are Mobitab and Sicherheitsausweis), Drucklufthammer and LuPanel U Hangar here.

Der Stationsalarm gibt ein ohrenbetäubenden Sirenenton von sich.

>up
(first opening Luke_Hangar)
It seems to be locked.

>take Sicherheitsausweis
Taken.

>use Sicherheitsausweis with Luke_Hangar
Du hast die Hangarluke für einen Zug geöffnet.

Die Hangarluke hat sich geschlossen

* * *

>outside
Docking Bay
You can see Weltraumtür here.

Der Stationsalarm gibt ein ohrenbetäubenden Sirenenton von sich.

>up
Hangar
You can see Luke_Hangar, Umkleidetür, Spind (in which are Mobitab and Sicherheitsausweis), Drucklufthammer and LuPanel U Hangar here.

Der Stationsalarm gibt ein ohrenbetäubenden Sirenenton von sich.

* * *

>take Mobitab
Du traust dir das nicht zu, das zu nehmen.

>look
Hangar
You can see Luke_Hangar, Umkleidetür, Spind (in which are Mobitab and Sicherheitsausweis) and Panel_Luke_H here.

>outside
You can't go that way.

>take Mobitab
Du traust dir das nicht zu, das zu nehmen.

>take sicherheitsausweis
Taken.

>use Sicherheitsausweis with Luke_Hangar
Du hast die Hangarluke für einen Zug geöffnet.

>up
Gamma Junction
You can see Luke_Hangar, Sicherheitsbarriere, Luke_XenoLab, Sicherheitsbarriere, Panel N Gam Junc and Panel S Gam Junc here.

Der Stationsalarm gibt ein ohrenbetäubenden Sirenenton von sich.

Die Hangarluke hat sich geschlossen

>up
(first opening Luke_XenoLab)

Xeno Lab
You can see Luke_XenoLab here.

Du spielst nun Barry!
Barry ist in Raumfähre
Szene 2:
Du bist Barry, nachdem du herausgefunden hast dass das Raumschiff einer aufwendigen Reparatur bedarf, wunderst du dich warum noch niemand gekommen ist und wo Percy seit dem Abholen der Palette abgeblieben ist. Du fängst an nach ihm zu suchen.

Der Stationsalarm gibt ein ohrenbetäubenden Sirenenton von sich.

>undo
Gamma Junction
[Previous turn undone.]

>use Sicherheitsausweis with Panel N Gam Junc
Du hast die zugehörige Tür des Panels entriegelt.

* * *

>n
Gamma Beta Corridor
You can see Sicherheitsbarriere, Sicherheitsbarriere, Panel N Gam Bet Cor and Panel S Gam Bet Cor here.

Der Stationsalarm gibt ein ohrenbetäubenden Sirenenton von sich.

>s
Gamma Junction
You can see Sicherheitsbarriere, Luke_Hangar, Sicherheitsbarriere, Luke_XenoLab, Panel N Gam Junc and Panel S Gam Junc here.

Der Stationsalarm gibt ein ohrenbetäubenden Sirenenton von sich.

>n
Gamma Beta Corridor
You can see Sicherheitsbarriere, Sicherheitsbarriere, Panel N Gam Bet Cor and Panel S Gam Bet Cor here.

Der Stationsalarm gibt ein ohrenbetäubenden Sirenenton von sich.

>n
(first opening Sicherheitsbarriere)
It seems to be locked.

>use Sicherheitsausweis with Panel N Gam Bet Cor
Du hast die zugehörige Tür des Panels entriegelt.

>n
Beta Junction
You can see Sicherheitsbarriere, Luke_Engineering, Sicherheitsbarriere, Panel N Bet Junc and Panel S Bet Junc here.

Der Stationsalarm gibt ein ohrenbetäubenden Sirenenton von sich.

>use Sicherheitsausweis with Panel S Bet Junc
Du hast die zugehörige Tür des Panels verriegelt.

>s
(first opening Sicherheitsbarriere)
It seems to be locked.

>use Sicherheitsausweis with Panel S Bet Junc
Du hast die zugehörige Tür des Panels entriegelt.

>s
Gamma Beta Corridor
You can see Sicherheitsbarriere, Sicherheitsbarriere, Panel N Gam Bet Cor and Panel S Gam Bet Cor here.

Der Stationsalarm gibt ein ohrenbetäubenden Sirenenton von sich.

>use Sicherheitsausweis with Panel S Bet Cor
(Panel S Gam Bet Cor)
Du hast die zugehörige Tür des Panels verriegelt.

>s
(first opening Sicherheitsbarriere)
It seems to be locked.

>use Sicherheitsausweis with Panel S Bet Cor
(Panel S Gam Bet Cor)
Du hast die zugehörige Tür des Panels entriegelt.

>s
Gamma Junction
You can see Sicherheitsbarriere, Luke_Hangar, Sicherheitsbarriere, Luke_XenoLab, Panel N Gam Junc and Panel S Gam Junc here.

Der Stationsalarm gibt ein ohrenbetäubenden Sirenenton von sich.

>s
(first opening Sicherheitsbarriere)
It seems to be locked.

>use Sicherheitsausweis with Panel S Gam Junc
Du hast die zugehörige Tür des Panels entriegelt.

>s
Gamma Delta Junction
You can see Sicherheitsbarriere, Sicherheitsbarriere, Panel N Gam Del Cor and Panel S Gam Del Cor here.

Der Stationsalarm gibt ein ohrenbetäubenden Sirenenton von sich.

>use Sicherheitsausweis with Panel S Gam Del Cor
Du hast die zugehörige Tür des Panels entriegelt.

>s
Delta Junction
You can see Sicherheitsbarriere, Sicherheitsbarriere, Luke_SolarLab, Panel N Del Junc and Panel S Del Junc here.

Der Stationsalarm gibt ein ohrenbetäubenden Sirenenton von sich.

>s
(first opening Sicherheitsbarriere)
It seems to be locked.

>n
Gamma Delta Junction
You can see Sicherheitsbarriere, Sicherheitsbarriere, Panel N Gam Del Cor and Panel S Gam Del Cor here.

Der Stationsalarm gibt ein ohrenbetäubenden Sirenenton von sich.

>n
Gamma Junction
You can see Sicherheitsbarriere, Sicherheitsbarriere, Luke_Hangar, Luke_XenoLab, Panel N Gam Junc and Panel S Gam Junc here.

Der Stationsalarm gibt ein ohrenbetäubenden Sirenenton von sich.

>s
Gamma Delta Junction
You can see Sicherheitsbarriere, Sicherheitsbarriere, Panel N Gam Del Cor and Panel S Gam Del Cor here.

Der Stationsalarm gibt ein ohrenbetäubenden Sirenenton von sich.

>s
Delta Junction
You can see Sicherheitsbarriere, Sicherheitsbarriere, Luke_SolarLab, Panel N Del Junc and Panel S Del Junc here.

Der Stationsalarm gibt ein ohrenbetäubenden Sirenenton von sich.

* * *

>up
Hangar
You can see Luke_Hangar, Umkleidetür, Spind (in which are Mobitab and Sicherheitsausweis), Drucklufthammer and LuPanel U Hangar here.

Der Stationsalarm gibt ein ohrenbetäubenden Sirenenton von sich.

>take sicherheitsausweis from spind
Taken.

* * *

>use sicherheitsausweis with panel s
(Panel S Gam Junc)
Du hast die zugehörige Tür des Panels entriegelt.

>go south
Percy findet eine Leiche und an den Wänden Spuren von Handlaserwaffen. Außerdem stellt er fest, dass der Öffnungshebel für die Wartungsluke zum Kommunikationsmodul durch Laserfeuer abgetrennt worden ist. Der Öffnungshebel liegt nun auf dem Boden, so dass ein Öffnen der Luke von hier aus nicht möglich ist. Was ist hier passiert? In dem Laborkittel der Leiche, die offenbar ein Wissenschaftler gewesen war, ist ein Transponder eingenäht. Wenn Percy den Kittel der Leiche auszieht und ihn selbst anzieht, könnte er hiermit die entsprechende Luke öffnen.

Gamma Delta Corridor
You can see Sicherheitsbarriere, Sicherheitsbarriere, Wartungsluke, Oeffnungshebel, Leiche (on which is Laborkittel), Panel N Gam Del Cor and Panel S Gam Del Cor here.

Der Stationsalarm gibt ein ohrenbetäubenden Sirenenton von sich.

* * *

>take sicherheitsausweis from spind
Taken.

>use sicherheitsausweis with lupnel
That noun did not make sense in this context.

>use sicherheitsausweis with lupanel
Du hast die Hangarluke für einen Zug geöffnet.

* * *

>use sicherheitsausweis with panel s
(Panel S Gam Junc)
Du hast die zugehörige Tür des Panels entriegelt.

>south
Gamma Delta Corridor
You can see Sicherheitsbarriere, Sicherheitsbarriere, Wartungsluke, Oeffnungshebel, Leiche (on which is Laborkittel), Panel N Gam Del Cor and Panel S Gam Del Cor here.

Der Stationsalarm gibt ein ohrenbetäubenden Sirenenton von sich.

>go north
Gamma Junction
Im Boden ist ein riesiges Bodenfenster eingelassen. Es sieht gar nicht mal so stabil aus.

You can see Sicherheitsbarriere, Luke_Hangar, Luke_XenoLab, Sicherheitsbarriere, Panel N Gam Junc, Panel S Gam Junc, LuPanel U Gam Junc and LuPanel D Gam Junc here.

Der Stationsalarm gibt ein ohrenbetäubenden Sirenenton von sich.

* * *

>push palette
Du kannst die Palette noch nicht bewegen! Versuche den Gravitationsgreifer anzubringen.

Der Stationsalarm gibt ein ohrenbetäubenden Sirenenton von sich.

>push palette outside
Palette cannot be pushed from place to place.

>connect gravitationsgreifer with palette
Du trägst nicht den Gravitationsgreifer!

>take gravitationsgreifer
Taken.

>connect gravitationsgreifer with palette
Du hast den Greifer an die Palette angebracht.

>push palette
Jetzt ist die Palette in Docking Bay

>outside
Docking Bay
You can see Weltraumtür and Palette here.

Der Stationsalarm gibt ein ohrenbetäubenden Sirenenton von sich.

>push palette
Jetzt ist die Palette in Raumfähre

>inside
Raumfähre
You can see Palette and Barry here.

Der Stationsalarm gibt ein ohrenbetäubenden Sirenenton von sich.

>push palette
Jetzt ist die Palette in Docking Bay

>outside
Docking Bay
You can see Palette and Weltraumtür here.

Der Stationsalarm gibt ein ohrenbetäubenden Sirenenton von sich.

>push palette
Jetzt ist die Palette in Raumfähre

* * *

>outside
Docking Bay
You can see Palette and Weltraumtür here.

Der Stationsalarm gibt ein ohrenbetäubenden Sirenenton von sich.

>go up
Hangar
You can see Luke_Hangar, Umkleidetür, Spind (in which are Mobitab and Sicherheitsausweis), Drucklufthammer and LuPanel U Hangar here.

Der Stationsalarm gibt ein ohrenbetäubenden Sirenenton von sich.

>go down
Docking Bay
You can see Palette and Weltraumtür here.

Der Stationsalarm gibt ein ohrenbetäubenden Sirenenton von sich.

>push palette
Jetzt ist die Palette in Raumfähre

* * *

>push palette
Jetzt ist die Palette in Docking Bay

>go down
You can't go that way.

>outside
Docking Bay
You can see Palette and Weltraumtür here.

Der Stationsalarm gibt ein ohrenbetäubenden Sirenenton von sich.

>push palette
Jetzt ist die Palette in Hangar

>go up
Hangar
You can see Palette, Luke_Hangar, Umkleidetür, Spind (in which are Mobitab and Sicherheitsausweis), Drucklufthammer and LuPanel U Hangar here.

Der Stationsalarm gibt ein ohrenbetäubenden Sirenenton von sich.

>use sicherheitsausweis with lupanel u hangar
Du trägst nicht den Sicherheitsausweis!

>take sicherheitsausweis from spind
Taken.

>use sicherheitsausweis with lupanel u hangar
Du hast die Hangarluke für einen Zug geöffnet.

>push palette
Jetzt ist die Palette in Gamma Junction

Die Hangarluke hat sich geschlossen

>push palette
You can't see any such thing.

>go up
(first opening Luke_Hangar)
It seems to be locked.

>use sicherheitsausweis with lupanel u hangar
Du hast die Hangarluke für einen Zug geöffnet.

>go up
Gamma Junction
Im Boden ist ein riesiges Bodenfenster eingelassen. Es sieht gar nicht mal so stabil aus.

You can see Luke_Hangar, Sicherheitsbarriere, Palette, Luke_XenoLab, Sicherheitsbarriere, Panel N Gam Junc, Panel S Gam Junc, LuPanel U Gam Junc and LuPanel D Gam Junc here.

Der Stationsalarm gibt ein ohrenbetäubenden Sirenenton von sich.

Die Hangarluke hat sich geschlossen

>use sicherheitsausweis with panel s
(Panel S Gam Junc)
Du hast die zugehörige Tür des Panels entriegelt.

* * *

>go south
Gamma Delta Junction
You can see Sicherheitsbarriere, Sicherheitsbarriere, Wartungsluke, Oeffnungshebel, Leiche (on which is Laborkittel), Panel N Gam Del Cor and Panel S Gam Del Cor here.

Der Stationsalarm gibt ein ohrenbetäubenden Sirenenton von sich.

>take laborkittel from leiche
Taken.

>go north
Gamma Junction
Im Boden ist ein riesiges Bodenfenster eingelassen. Es sieht gar nicht mal so stabil aus.

You can see Sicherheitsbarriere, Luke_Hangar, Palette, Luke_XenoLab, Sicherheitsbarriere, Panel N Gam Junc, Panel S Gam Junc, LuPanel U Gam Junc and LuPanel D Gam Junc here.

Der Stationsalarm gibt ein ohrenbetäubenden Sirenenton von sich.

>use sicherheitsausweis with panel s
(Panel S Gam Junc)
Du hast die zugehörige Tür des Panels verriegelt.

>wear
What do you want to wear?

>wear laborkittel
You put on Laborkittel.

>use laborkittel with luke_xenolab
Du hast die XenoLab Luke für einen Zug geöffnet.

>push palette
Der Antigravitationsgreifer wird durch den Maschinenkern der Station überlastet. Die Palette blockiert nun die Xeno-Luke und du kannst in das Xeno Lab eintreten

>go up
Xeno Lab
You can see Luke_XenoLab, Palette, XenoKnopf and Klappe (closed) here.

Der Stationsalarm gibt ein ohrenbetäubenden Sirenenton von sich.
Durch das Deckenfenster sieht man den grün glühenden  Maschinenkern.
Ein ohrenbetäubendes Pfeifen ist zu hören.

>take xenoknopf
That's fixed in place.

>open klappe
It seems to be locked.

>press xenoknopf
Tatsächlich tut es das, das Pfeifen und der Alarm verstummen. Eine Klappe in der Wand öffnet sich und gibt den Blick auf eine Phiole mit rosafarbenen Nebel frei.

>take phiole
Als Percy versucht, sie an sich zu nehmen, entgleitet sie ihm und faällt auf den Boden und zerbricht. Sofort wird der Nebel freigesetzt, die ihm den Atem abschnüren. Er wird Kontaminiert und blickt fortan mit starren Blick in die Gegend. Das blinken des Knopfes erlischt und der Knopf ist nun ohne Funktion.

Du spielst nun Barry!
Barry ist in Raumfähre
Szene 2:
Du bist Barry. Nachdem du herausgefunden hast dass das Raumschiff einer aufwendigen Reparatur bedarf, wunderst du dich warum noch niemand gekommen ist und wo Percy seit dem Abholen der Palette abgeblieben ist. Du fängst an nach ihm zu suchen.

Der Stationsalarm gibt ein ohrenbetäubenden Sirenenton von sich.

>restart
Are you sure you want to restart?

>yes
Szene 1:
Percy fliegt die Fähre, Barry übernimmt die Kommunikation. Als sie sich der Station nähern wundern sie sich, dass zwar der automatische Leitstrahl funktioniert, sie jedoch keine Antwort auf ihre Landeanfrage erhalten. Da der Leitstrahl sie führt und das automatische Andocken einleitet, denken sie sich nichts weiter und halten das für ein eventuelles Willkommensritual des Außenpostens. Ein knarrendes Gera¨usch beim Einflug in die DockingBay la¨sst aber nichts Gutes ahnen. Als sie aus der Fähre aussteigen, finden sie den Dock- und Hangarbereich verlassen vor. Sie sind verwundert und einigen sich darauf, dass Barry die Fähre äußerlich bzgl. des entstandenen Schadens untersucht. Percy soll derweil nach dem Stationspersonal recherchieren und sich auf der Brücke beim wachhabenden Offizier meldet.

Lupus Station
An Interactive Fiction by Team14 Use MAX_STATIC_DATA of 100000000
Release 1 / Serial number 180702 / Inform 7 build 6M62 (I6/v6.33 lib 6/12N) SD

Raumfähre
You can see Palette, Barry and Gravitationsgreifer here.

>go outside
Docking Bay
You can see Weltraumtür here.

Der Stationsalarm gibt ein ohrenbetäubenden Sirenenton von sich.

* * *

>use sicherheitsausweis with lupanel u hangar
Du hast die Hangarluke für einen Zug geöffnet.

>go up
Gamma Junction
Im Boden ist ein riesiges Bodenfenster eingelassen. Es sieht gar nicht mal so stabil aus.

You can see Luke_Hangar, Sicherheitsbarriere, Luke_XenoLab, Sicherheitsbarriere, Panel N Gam Junc, Panel S Gam Junc, LuPanel U Gam Junc and LuPanel D Gam Junc here.

Der Stationsalarm gibt ein ohrenbetäubenden Sirenenton von sich.

Die Hangarluke hat sich geschlossen

>use laborkittel with luke_xenolab
You can't see any such thing.

>use sicherheitsausweis with lupanel u hangar
That noun did not make sense in this context.

>use sicherheitsausweis with panel s
(Panel S Gam Junc)
Du hast die zugehörige Tür des Panels entriegelt.

* * *

>take laborkittel from leiche
Taken.

>go north
Gamma Junction
Im Boden ist ein riesiges Bodenfenster eingelassen. Es sieht gar nicht mal so stabil aus.

You can see Sicherheitsbarriere, Luke_Hangar, Luke_XenoLab, Sicherheitsbarriere, Panel N Gam Junc, Panel S Gam Junc, LuPanel U Gam Junc and LuPanel D Gam Junc here.

Der Stationsalarm gibt ein ohrenbetäubenden Sirenenton von sich.

>use laborkittel with luke_xenolab
Du hast den Laborkittel nicht an, du musst in anziehen damit du die Luke öffnen kannst!

>go south
Gamma Delta Junction
You can see Sicherheitsbarriere, Sicherheitsbarriere, Wartungsluke, Oeffnungshebel, Leiche, Panel N Gam Del Cor and Panel S Gam Del Cor here.

Der Stationsalarm gibt ein ohrenbetäubenden Sirenenton von sich.

>take oeffnungshebel
Taken.

* * *

>take
What do you want to take?

>take Tür1
That's fixed in place.

>take Mobitab
Taken.

>use Mobitab with Panel2
Du hast die zugehörige Tür des Panels entriegelt.

>open Tür1
You open Tür1.

>go w
You can't, since Tür1 leads nowhere.

>w
You can't, since Tür1 leads nowhere.

* * *

>take Hallo
Taken.

>drop Hallo
Dropped.

>take Hallo
Taken.

>go down
Gamma Junction

* * *

>go up
Xeno Lab
You can see Adam here.

>drop hallo
Dropped.

>take hallo
Taken.

>drop hallo
Dropped.

* * *

>take hallo
Taken.

>go down
Gamma Junction

>go up
Xeno Lab
You can see Adam here.

* * *

>take hallo
Taken.

>go dwon
You can't see any such thing.

>go down
Gamma Junction

* * *

>take Hallo
Taken.

>drop hallo
Dropped.

* * *

>take hallo
Taken.

>go down
Gamma Junction
ok

* * *

>take MobiTab
Taken.

>use MobiTab with Panel Norden
That noun did not make sense in this context.

>use MobiTab with Panel_GamJun
Du hast die zugehörige Tür des Panels entriegelt.

>use MobiTab with Panel Norden
That noun did not make sense in this context.

* * *

>take MobiTab
Taken.

>use MobiTab with Panel_GamJun
Du hast die zugehörige Tür des Panels entriegelt.

>n
(first opening Sicherheitsbarriere)

Gamma Beta Corridor
You can see Sicherheitsbarriere and Sicherheitsbarriere here.

* * *

>take antigravitationsgreifer
You can't see any such thing.

>take gravitationsgreifer
Taken.

Der Stationsalarm gibt ein ohrenbetäubenden Sirenenton von sich.

>connect Graviationsgreifer with palette
You can't see any such thing.

>connect Gravitationsgreifer with palette
Du hast den Greifer an die Palette angebracht.

>push palette
Jetzt ist die Palette in Docking Bay

>go outside
Docking Bay
You can see Weltraumtür and Palette here.

Der Stationsalarm gibt ein ohrenbetäubenden Sirenenton von sich.

>push palettte
You can't see any such thing.

>push palette
Jetzt ist die Palette in Raumfähre

>go inside
Raumfähre
You can see Palette and Barry here.

Der Stationsalarm gibt ein ohrenbetäubenden Sirenenton von sich.

>push palette
Jetzt ist die Palette in Docking Bay

>go outside
Docking Bay
You can see Palette and Weltraumtür here.

Der Stationsalarm gibt ein ohrenbetäubenden Sirenenton von sich.

>push palette
Jetzt ist die Palette in Raumfähre

* * *

>go outside
Docking Bay
You can see Palette and Weltraumtür here.

Der Stationsalarm gibt ein ohrenbetäubenden Sirenenton von sich.

>go up
Hangar
You can see Luke_Hangar, Umkleidetür, Spind (in which are Mobitab and Sicherheitsausweis), Drucklufthammer and LuPanel U Hangar here.

Der Stationsalarm gibt ein ohrenbetäubenden Sirenenton von sich.

* * *

>go down
Docking Bay
You can see Palette and Weltraumtür here.

Der Stationsalarm gibt ein ohrenbetäubenden Sirenenton von sich.

>push palette
Jetzt ist die Palette in Hangar

* * *

>go up
Hangar
You can see Palette, Luke_Hangar, Umkleidetür, Spind (in which are Mobitab and Sicherheitsausweis), Drucklufthammer and LuPanel U Hangar here.

Der Stationsalarm gibt ein ohrenbetäubenden Sirenenton von sich.

>push palette
Jetzt ist die Palette in Docking Bay

>go down
Docking Bay
You can see Palette and Weltraumtür here.

Der Stationsalarm gibt ein ohrenbetäubenden Sirenenton von sich.

* * *

>go up
Hangar
You can see Palette, Luke_Hangar, Umkleidetür, Spind (in which are Mobitab and Sicherheitsausweis), Drucklufthammer and LuPanel U Hangar here.

Der Stationsalarm gibt ein ohrenbetäubenden Sirenenton von sich.

>take sicherheitsausweis from spind
Taken.

>use sicherheitsausweis with panel
Which do you mean, Panel N Gam Del Cor, Panel S Gam Del Cor, Panel N Alp Bet Cor, Panel S Alp Bet Cor, Panel N Alp Del Cor, Panel S Alp Del Cor, Panel N Gam Junc, Panel S Gam Junc, Panel N Gam Bet Cor, Panel S Gam Bet Cor, Panel N Bet Junc, Panel S Bet Junc, Panel N Alp Junc, Panel S Alp Junc, Panel N Del Junc or Panel S Del Junc?

>use sicherheitsausweis with panel n
Which do you mean, Panel N Gam Del Cor, Panel N Alp Bet Cor, Panel N Alp Del Cor, Panel N Gam Junc, Panel N Gam Bet Cor, Panel N Bet Junc, Panel N Alp Junc or Panel N Del Junc?

>use sicherheitsausweis with panel u
That noun did not make sense in this context.

>use sicherheitsausweis with panel
Which do you mean, Panel N Gam Del Cor, Panel S Gam Del Cor, Panel N Alp Bet Cor, Panel S Alp Bet Cor, Panel N Alp Del Cor, Panel S Alp Del Cor, Panel N Gam Junc, Panel S Gam Junc, Panel N Gam Bet Cor, Panel S Gam Bet Cor, Panel N Bet Junc, Panel S Bet Junc, Panel N Alp Junc, Panel S Alp Junc, Panel N Del Junc or Panel S Del Junc?

>use sicherheitsausweis with panel h
That noun did not make sense in this context.

>go up
(first opening Luke_Hangar)
It seems to be locked.

>use sicherheitsausweis with luke_hangar
That noun did not make sense in this context.

>use sicherheitsausweis with panel
Which do you mean, Panel N Gam Del Cor, Panel S Gam Del Cor, Panel N Alp Bet Cor, Panel S Alp Bet Cor, Panel N Alp Del Cor, Panel S Alp Del Cor, Panel N Gam Junc, Panel S Gam Junc, Panel N Gam Bet Cor, Panel S Gam Bet Cor, Panel N Bet Junc, Panel S Bet Junc, Panel N Alp Junc, Panel S Alp Junc, Panel N Del Junc or Panel S Del Junc?

* * *

>use sicherheitsausweis with panel n
Which do you mean, Panel N Gam Del Cor, Panel N Alp Bet Cor, Panel N Alp Del Cor, Panel N Gam Junc, Panel N Gam Bet Cor, Panel N Bet Junc, Panel N Alp Junc or Panel N Del Junc?

>use sicherheitsausweis with panel s gam junc
You can't reach into Gamma Junction.

>use sicherheitsausweis with panel n gam junc
You can't reach into Gamma Junction.

>use sicherheitsausweis with panel hangar
That noun did not make sense in this context.

>use sicherheitsausweis with lupanel u hangar
Du hast die Hangarluke für einen Zug geöffnet.

>push palette
Jetzt ist die Palette in Docking Bay
Die Hangarluke hat sich geschlossen

>go down
Docking Bay
You can see Palette and Weltraumtür here.

Der Stationsalarm gibt ein ohrenbetäubenden Sirenenton von sich.

* * *

>push palette
Jetzt ist die Palette in Hangar

>go up
Hangar
You can see Palette, Luke_Hangar, Umkleidetür, Spind (in which is Mobitab), Drucklufthammer and LuPanel U Hangar here.

Der Stationsalarm gibt ein ohrenbetäubenden Sirenenton von sich.

>use sicherheitsausweis with lupanel u hangar
Du hast die Hangarluke für einen Zug geöffnet.

>push palette
Jetzt ist die Palette in Gamma Junction
Die Hangarluke hat sich geschlossen

>use sicherheitsausweis with lupanel u hangar
Du hast die Hangarluke für einen Zug geöffnet.

* * *

>go up
Gamma Junction
Im Boden ist ein riesiges Bodenfenster eingelassen. Es sieht gar nicht mal so stabil aus.

You can see Luke_Hangar, Sicherheitsbarriere, Palette, Luke_XenoLab, Sicherheitsbarriere, Panel N Gam Junc, Panel S Gam Junc, LuPanel U Gam Junc and LuPanel D Gam Junc here.

Der Stationsalarm gibt ein ohrenbetäubenden Sirenenton von sich.

Die Hangarluke hat sich geschlossen

>use sicherheitsausweis with lupanel u gam junc
That noun did not make sense in this context.

>go north
(first opening Sicherheitsbarriere)
It seems to be locked.

>use sicherheitsausweis with panel n gam junc
Du hast die zugehörige Tür des Panels entriegelt.

>go north
Gamma Beta Corridor
You can see Sicherheitsbarriere, Sicherheitsbarriere, Panel N Gam Bet Cor and Panel S Gam Bet Cor here.

Der Stationsalarm gibt ein ohrenbetäubenden Sirenenton von sich.

>go south
Gamma Junction
Im Boden ist ein riesiges Bodenfenster eingelassen. Es sieht gar nicht mal so stabil aus.

You can see Sicherheitsbarriere, Luke_Hangar, Sicherheitsbarriere, Palette, Luke_XenoLab, Panel N Gam Junc, Panel S Gam Junc, LuPanel U Gam Junc and LuPanel D Gam Junc here.

Der Stationsalarm gibt ein ohrenbetäubenden Sirenenton von sich.

>use sicherheitsausweis with panel s gam junc
Du hast die zugehörige Tür des Panels entriegelt.

>go south
Gamma Delta Junction
You can see Sicherheitsbarriere, Sicherheitsbarriere, Wartungsluke, Oeffnungshebel, Leiche (on which is Laborkittel), Panel N Gam Del Cor and Panel S Gam Del Cor here.

Der Stationsalarm gibt ein ohrenbetäubenden Sirenenton von sich.

* * *

>take laborkittel from leiche
Taken.

>go north
Gamma Junction
Im Boden ist ein riesiges Bodenfenster eingelassen. Es sieht gar nicht mal so stabil aus.

You can see Sicherheitsbarriere, Sicherheitsbarriere, Luke_Hangar, Palette, Luke_XenoLab, Panel N Gam Junc, Panel S Gam Junc, LuPanel U Gam Junc and LuPanel D Gam Junc here.

Der Stationsalarm gibt ein ohrenbetäubenden Sirenenton von sich.

>use laborkittel with lupanel u gam junc
You can't see any such thing.

>use laborkittel with luke
You can't see any such thing.

>use laborkittel with luke_xenolab
Du hast den Laborkittel nicht an, du musst in anziehen damit du die Luke öffnen kannst!

>wear laborkittel
You put on Laborkittel.

* * *

>use laborkittel with luke_xenolab
Du hast die XenoLab Luke für einen Zug geöffnet.

>push palette
Jetzt ist die Palette in Gamma Delta Junction

>go north
Gamma Beta Corridor
You can see Sicherheitsbarriere, Sicherheitsbarriere, Panel N Gam Bet Cor and Panel S Gam Bet Cor here.

Der Stationsalarm gibt ein ohrenbetäubenden Sirenenton von sich.

>go south
Gamma Junction
Im Boden ist ein riesiges Bodenfenster eingelassen. Es sieht gar nicht mal so stabil aus.

You can see Sicherheitsbarriere, Sicherheitsbarriere, Luke_Hangar, Luke_XenoLab, Panel N Gam Junc, Panel S Gam Junc, LuPanel U Gam Junc and LuPanel D Gam Junc here.

Der Stationsalarm gibt ein ohrenbetäubenden Sirenenton von sich.

>go south
Gamma Delta Junction
You can see Sicherheitsbarriere, Palette, Sicherheitsbarriere, Wartungsluke, Oeffnungshebel, Leiche, Panel N Gam Del Cor and Panel S Gam Del Cor here.

Der Stationsalarm gibt ein ohrenbetäubenden Sirenenton von sich.

>push palette
Jetzt ist die Palette in Wartungsschacht

>go up
You can't go that way.

>go down
(first opening Wartungsluke)

Wartungsschacht
You can see Wartungsluke and Palette here.

Der Stationsalarm gibt ein ohrenbetäubenden Sirenenton von sich.

>psuh palette
That's not a verb I recognise.

>push palettte
You can't see any such thing.

>push palette
Jetzt ist die Palette in Gamma Delta Junction

>go up
Die eingeklemmte Palette löst sich. Sie hat sich durch die zugehende Luke so sehr beschleunigt dass das Bodenfenster kaputt geht! Der Sauerstoff wird nun weniger im äußeren Ring!

Gamma Delta Junction
You can see Wartungsluke, Sicherheitsbarriere, Sicherheitsbarriere, Oeffnungshebel, Leiche, Panel N Gam Del Cor and Panel S Gam Del Cor here.

Der Stationsalarm gibt ein ohrenbetäubenden Sirenenton von sich.

>push palette
You can't see any such thing.

>restart
Are you sure you want to restart?

* * *

>o outside
Sorry, that can't be corrected.

>go outside
Docking Bay
You can see Weltraumtür here.

Der Stationsalarm gibt ein ohrenbetäubenden Sirenenton von sich.

* * *

>go up
Hangar
You can see Luke_Hangar, Umkleidetür, Spind (in which are Mobitab and Sicherheitsausweis), Drucklufthammer and LuPanel U Hangar here.

Der Stationsalarm gibt ein ohrenbetäubenden Sirenenton von sich.

>take mobitab from spind
Du traust dir das nicht zu, das zu nehmen.

* * *

>take gravitationsgreifer
Taken.

Der Stationsalarm gibt ein ohrenbetäubenden Sirenenton von sich.

>connect gravitationsgreifer with palette
Du hast den Greifer an die Palette angebracht.

* * *

>go outside
Docking Bay
You can see Weltraumtür and Palette here.

Der Stationsalarm gibt ein ohrenbetäubenden Sirenenton von sich.

>push palette
Jetzt ist die Palette in Raumfähre

* * *

>push palette
Jetzt ist die Palette in Hangar

>go up
Hangar
You can see Luke_Hangar, Palette, Umkleidetür, Spind (in which are Mobitab and Sicherheitsausweis), Drucklufthammer and LuPanel U Hangar here.

Der Stationsalarm gibt ein ohrenbetäubenden Sirenenton von sich.

>take sicherheitsausweis from spind
Taken.

* * *

>use sicherheitsausweis with lupanel
Du hast die Hangarluke für einen Zug geöffnet.

>push palette
Jetzt ist die Palette in Gamma Junction

Die Hangarluke hat sich geschlossen!

>use sicherheitsausweis with lupanel
Du hast die Hangarluke für einen Zug geöffnet.

>go up
Gamma Junction
Im Boden ist ein riesiges Bodenfenster eingelassen. Es sieht gar nicht mal so stabil aus.

You can see Luke_Hangar, Sicherheitsbarriere, Palette, Luke_XenoLab, Sicherheitsbarriere, Panel N Gam Junc, Panel S Gam Junc, LuPanel U Gam Junc and LuPanel D Gam Junc here.

Der Stationsalarm gibt ein ohrenbetäubenden Sirenenton von sich.

Die Hangarluke hat sich geschlossen!

>use sicherheitsausweis with panel n
(Panel N Gam Junc)
Du hast die zugehörige Tür des Panels entriegelt.

>use sicherheitsausweis with panel n
(Panel N Gam Junc)
Du hast die zugehörige Tür des Panels verriegelt.

>use sicherheitsausweis with panel s
(Panel S Gam Junc)
Du hast die zugehörige Tür des Panels entriegelt.

* * *

>go north
Gamma Junction
Im Boden ist ein riesiges Bodenfenster eingelassen. Es sieht gar nicht mal so stabil aus.

You can see Sicherheitsbarriere, Luke_Hangar, Palette, Luke_XenoLab, Sicherheitsbarriere, Panel N Gam Junc, Panel S Gam Junc, LuPanel U Gam Junc and LuPanel D Gam Junc here.

Der Stationsalarm gibt ein ohrenbetäubenden Sirenenton von sich.

>go north
(first opening Sicherheitsbarriere)
It seems to be locked.

>use sicherheitsausweis with panel s
(Panel S Gam Junc)
Du hast die zugehörige Tür des Panels verriegelt.

>wear laborkittel
You put on Laborkittel.

* * *

>use laborkittel with luke_xenolab
Du hast die XenoLab Luke für einen Zug geöffnet.

>push palette
Jetzt ist die Palette in Storage Area

>go west
You can't go that way.

>go east
Storage Area
You can see Luke_Delta_AI, Palette and LuPanel U Stor Ar here.

Der Stationsalarm gibt ein ohrenbetäubenden Sirenenton von sich.

>push palette
Jetzt ist die Palette in Gamma Junction

>go west
Gamma Junction
Im Boden ist ein riesiges Bodenfenster eingelassen. Es sieht gar nicht mal so stabil aus.

You can see Palette, Sicherheitsbarriere, Luke_Hangar, Luke_XenoLab, Sicherheitsbarriere, Panel N Gam Junc, Panel S Gam Junc, LuPanel U Gam Junc and LuPanel D Gam Junc here.

Der Stationsalarm gibt ein ohrenbetäubenden Sirenenton von sich.

>use laborkittel with luke_xenolab
Du hast die XenoLab Luke für einen Zug geöffnet.

>push palette
Der Antigravitationsgreifer wird durch den Maschinenkern der Station überlastet. Die Palette blockiert nun die Xeno-Luke und du kannst in das Xeno Lab eintreten.

>go up
Xeno Lab
You can see Luke_XenoLab, Palette, XenoKnopf and Klappe (closed) here.

Der Stationsalarm gibt ein ohrenbetäubenden Sirenenton von sich.
Durch das Deckenfenster sieht man den grün glühenden  Maschinenkern.
Ein ohrenbetäubendes Pfeifen ist zu hören.

>press xenoknopf
Tatsächlich tut es das, das Pfeifen und der Alarm verstummen. Eine Klappe in der Wand öffnet sich und gibt den Blick auf eine Phiole mit rosafarbenen Nebel frei.

* * *

>go outside
Docking Bay
You can see Weltraumtür here.

Der Stationsalarm gibt ein ohrenbetäubenden Sirenenton von sich.

>go up
Hangar
You can see Luke_Hangar, Umkleidetür, Spind (in which is Mobitab), Drucklufthammer and LuPanel U Hangar here.

Der Stationsalarm gibt ein ohrenbetäubenden Sirenenton von sich.

>take mobitab from spind
Taken.

>hit lupanel with mobitab
(LuPanel U Hangar with Mobitab)
Du hast das Panel kaputtgemacht. Jetzt kannst du über die Luke manuell öffnen oder schließen.

>go up
(first opening Luke_Hangar)

Gamma Junction
Im Boden ist ein riesiges Bodenfenster eingelassen. Es sieht gar nicht mal so stabil aus.

You can see Luke_Hangar, Luke_XenoLab, Sicherheitsbarriere, Sicherheitsbarriere, Panel N Gam Junc, Panel S Gam Junc, LuPanel U Gam Junc and LuPanel D Gam Junc here.

Der Stationsalarm gibt ein ohrenbetäubenden Sirenenton von sich.
Ein ohrenbetäubendes Pfeifen ist aus dem Xeno Lab zu hören.

>go up
Xeno Lab
You can see Luke_XenoLab, Sicherheitsausweis, Percy, Palette, XenoKnopf and Klappe (in which is Phiole) here.

Mobi Tab:  Anzahl der Kontaminierten: 1
Der Stationsalarm gibt ein ohrenbetäubenden Sirenenton von sich.
Durch das Deckenfenster sieht man den grün glühenden  Maschinenkern.

>clap in hands
Du hast in die Hände geklatscht doch der Stationsalarm ist zu laut!

Mobi Tab:  Anzahl der Kontaminierten: 1

>clap in hands
Du hast in die Hände geklatscht doch der Stationsalarm ist zu laut!

Mobi Tab:  Anzahl der Kontaminierten: 1

>go down
Gamma Junction
Im Boden ist ein riesiges Bodenfenster eingelassen. Es sieht gar nicht mal so stabil aus.

You can see Luke_XenoLab, Luke_Hangar, Sicherheitsbarriere, Sicherheitsbarriere, Panel N Gam Junc, Panel S Gam Junc, LuPanel U Gam Junc and LuPanel D Gam Junc here.

Der Stationsalarm gibt ein ohrenbetäubenden Sirenenton von sich.
Ein ohrenbetäubendes Pfeifen ist aus dem Xeno Lab zu hören.

>go down
Hangar
You can see Luke_Hangar, Umkleidetür, Spind (empty), Drucklufthammer and LuPanel U Hangar here.

Der Stationsalarm gibt ein ohrenbetäubenden Sirenenton von sich.

>take drucklufthammer
Taken.

>go up
Gamma Junction
Im Boden ist ein riesiges Bodenfenster eingelassen. Es sieht gar nicht mal so stabil aus.

You can see Luke_Hangar, Luke_XenoLab, Sicherheitsbarriere, Sicherheitsbarriere, Panel N Gam Junc, Panel S Gam Junc, LuPanel U Gam Junc and LuPanel D Gam Junc here.

Der Stationsalarm gibt ein ohrenbetäubenden Sirenenton von sich.
Ein ohrenbetäubendes Pfeifen ist aus dem Xeno Lab zu hören.

>go up
Xeno Lab
You can see Luke_XenoLab, Sicherheitsausweis, Percy, Palette, XenoKnopf and Klappe (in which is Phiole) here.

Mobi Tab:  Anzahl der Kontaminierten: 1
Der Stationsalarm gibt ein ohrenbetäubenden Sirenenton von sich.
Durch das Deckenfenster sieht man den grün glühenden  Maschinenkern.

>use drucklufthammer
Du hast mit dem Drucklufthammer ein lautes Geräusch gemacht und der Kontaminierte hat dich bemerkt!

Mobi Tab:  Anzahl der Kontaminierten: 1

>wait
Time passes.

Mobi Tab:  Anzahl der Kontaminierten: 1

>go down
Gamma Junction
Im Boden ist ein riesiges Bodenfenster eingelassen. Es sieht gar nicht mal so stabil aus.

You can see Luke_XenoLab, Percy, Luke_Hangar, Sicherheitsbarriere, Sicherheitsbarriere, Panel N Gam Junc, Panel S Gam Junc, LuPanel U Gam Junc and LuPanel D Gam Junc here.

Mobi Tab:  Anzahl der Kontaminierten: 1
Der Stationsalarm gibt ein ohrenbetäubenden Sirenenton von sich.
Ein ohrenbetäubendes Pfeifen ist aus dem Xeno Lab zu hören.

>charge drucklufthammer with panel s
(Panel S Gam Junc)
Du hast den Drucklufthammer aufgeladen.

Mobi Tab:  Anzahl der Kontaminierten: 1

>go down
Hangar
You can see Luke_Hangar, Umkleidetür, Spind (empty) and LuPanel U Hangar here.

Der Stationsalarm gibt ein ohrenbetäubenden Sirenenton von sich.

>go up
Gamma Junction
Im Boden ist ein riesiges Bodenfenster eingelassen. Es sieht gar nicht mal so stabil aus.

You can see Luke_Hangar, Luke_XenoLab, Percy, Sicherheitsbarriere, Sicherheitsbarriere, Panel N Gam Junc, Panel S Gam Junc, LuPanel U Gam Junc and LuPanel D Gam Junc here.

Mobi Tab:  Anzahl der Kontaminierten: 1
Der Stationsalarm gibt ein ohrenbetäubenden Sirenenton von sich.
Ein ohrenbetäubendes Pfeifen ist aus dem Xeno Lab zu hören.

>hit panel s with mibitab
That noun did not make sense in this context.

>hit panel s with mobitab
That noun did not make sense in this context.

>go up
Xeno Lab
You can see Luke_XenoLab, Sicherheitsausweis, Palette, XenoKnopf and Klappe (in which is Phiole) here.

Der Stationsalarm gibt ein ohrenbetäubenden Sirenenton von sich.
Durch das Deckenfenster sieht man den grün glühenden  Maschinenkern.

>take sicherheitsausweis
Taken.

>go down
Gamma Junction
Im Boden ist ein riesiges Bodenfenster eingelassen. Es sieht gar nicht mal so stabil aus.

You can see Luke_XenoLab, Luke_Hangar, Percy, Sicherheitsbarriere, Sicherheitsbarriere, Panel N Gam Junc, Panel S Gam Junc, LuPanel U Gam Junc and LuPanel D Gam Junc here.

Mobi Tab:  Anzahl der Kontaminierten: 1
Der Stationsalarm gibt ein ohrenbetäubenden Sirenenton von sich.
Ein ohrenbetäubendes Pfeifen ist aus dem Xeno Lab zu hören.

>use sicherheitsausweis with panel s
(Panel S Gam Junc)
Du hast die zugehörige Tür des Panels entriegelt.

Mobi Tab:  Anzahl der Kontaminierten: 1

>go down
Hangar
You can see Luke_Hangar, Umkleidetür, Spind (empty) and LuPanel U Hangar here.

Der Stationsalarm gibt ein ohrenbetäubenden Sirenenton von sich.

* * *

>go up
Gamma Junction
Im Boden ist ein riesiges Bodenfenster eingelassen. Es sieht gar nicht mal so stabil aus.

You can see Luke_Hangar, Luke_XenoLab, Percy, Sicherheitsbarriere, Sicherheitsbarriere, Panel N Gam Junc, Panel S Gam Junc, LuPanel U Gam Junc and LuPanel D Gam Junc here.

Mobi Tab:  Anzahl der Kontaminierten: 1
Der Stationsalarm gibt ein ohrenbetäubenden Sirenenton von sich.
Ein ohrenbetäubendes Pfeifen ist aus dem Xeno Lab zu hören.

>use drucklufthammer
Du hast mit dem Drucklufthammer ein lautes Geräusch gemacht und der Kontaminierte hat dich bemerkt!

Mobi Tab:  Anzahl der Kontaminierten: 1

* * *

>wait
Time passes.

Mobi Tab:  Anzahl der Kontaminierten: 1

>go south
Gamma Delta Junction
You can see Sicherheitsbarriere, Percy, Sicherheitsbarriere, Wartungsluke, Oeffnungshebel, Leiche, Panel N Gam Del Cor and Panel S Gam Del Cor here.

Mobi Tab:  Anzahl der Kontaminierten: 1
Der Stationsalarm gibt ein ohrenbetäubenden Sirenenton von sich.

>use sicherheitsausweis with panel s
(Panel S Gam Del Cor)
Du hast die zugehörige Tür des Panels entriegelt.

Mobi Tab:  Anzahl der Kontaminierten: 1

>charge drucklufthammer with panel s
(Panel S Gam Del Cor)
Du hast den Drucklufthammer aufgeladen.

Mobi Tab:  Anzahl der Kontaminierten: 1

>go north
Gamma Junction
Im Boden ist ein riesiges Bodenfenster eingelassen. Es sieht gar nicht mal so stabil aus.

You can see Sicherheitsbarriere, Luke_Hangar, Luke_XenoLab, Sicherheitsbarriere, Panel N Gam Junc, Panel S Gam Junc, LuPanel U Gam Junc and LuPanel D Gam Junc here.

Der Stationsalarm gibt ein ohrenbetäubenden Sirenenton von sich.
Ein ohrenbetäubendes Pfeifen ist aus dem Xeno Lab zu hören.

>go south
Gamma Delta Junction
You can see Sicherheitsbarriere, Percy, Sicherheitsbarriere, Wartungsluke, Oeffnungshebel, Leiche, Panel N Gam Del Cor and Panel S Gam Del Cor here.

Mobi Tab:  Anzahl der Kontaminierten: 1
Der Stationsalarm gibt ein ohrenbetäubenden Sirenenton von sich.

>use drucklufthammer
Du hast mit dem Drucklufthammer ein lautes Geräusch gemacht und der Kontaminierte hat dich bemerkt!

Mobi Tab:  Anzahl der Kontaminierten: 1

* * *

>wait
Time passes.

Mobi Tab:  Anzahl der Kontaminierten: 1

>go south
Delta Junction
You can see Sicherheitsbarriere, Sicherheitsbarriere, Percy, Luke_SolarLab, Panel N Del Junc, Panel S Del Junc and LuPanel U Del Junc here.

Mobi Tab:  Anzahl der Kontaminierten: 1
Der Stationsalarm gibt ein ohrenbetäubenden Sirenenton von sich.

>charge drucklufthammer with panel s
(Panel S Del Junc)
Du hast den Drucklufthammer aufgeladen.

Mobi Tab:  Anzahl der Kontaminierten: 1

>use sicherheitsausweis with panel s
(Panel S Del Junc)
Du hast die zugehörige Tür des Panels entriegelt.

Mobi Tab:  Anzahl der Kontaminierten: 1

>go north
Gamma Delta Junction
You can see Sicherheitsbarriere, Sicherheitsbarriere, Wartungsluke, Oeffnungshebel, Leiche, Panel N Gam Del Cor and Panel S Gam Del Cor here.

Der Stationsalarm gibt ein ohrenbetäubenden Sirenenton von sich.

>go south
Delta Junction
You can see Sicherheitsbarriere, Sicherheitsbarriere, Percy, Luke_SolarLab, Panel N Del Junc, Panel S Del Junc and LuPanel U Del Junc here.

Mobi Tab:  Anzahl der Kontaminierten: 1
Der Stationsalarm gibt ein ohrenbetäubenden Sirenenton von sich.

>use drucklufthammer
Du hast mit dem Drucklufthammer ein lautes Geräusch gemacht und der Kontaminierte hat dich bemerkt!

Mobi Tab:  Anzahl der Kontaminierten: 1

* * *

>wait
Time passes.

Mobi Tab:  Anzahl der Kontaminierten: 1

>go south
Es ist nicht mehr möglich Percy zu dekontaminieren! (Percy und ein anderer Kontaminierter befinden sich in einem Raum)

    *** The End ***

Would you like to RESTART, RESTORE a saved game, QUIT or UNDO the last command?

* * *

>talk with Kontaminierter
Du hast den Kontaminierten angesprochen.

>talk with Kontaminierter
Du hast den Kontaminierten angesprochen.

>talk with Kontaminierter
Du hast den Kontaminierten angesprochen.

Du wurdest kontaminiert

    *** The End ***

Would you like to RESTART, RESTORE a saved game, QUIT or UNDO the last command?

* * *

>teleport Gamma_Jucntion
I didn't understand that sentence.

>teleport Gamma_Junction
I didn't understand that sentence.

>teleport to Gamma_Junction
Gamma Junction
You can see Sicherheitsbarriere, Luke_Hangar, Luke_XenoLab, Sicherheitsbarriere, Panel N Gam Junc, Panel S Gam Junc, Panel U Gam Junc and Panel D Gam Junc here.

Der Stationsalarm gibt ein ohrenbetäubenden Sirenenton von sich.

>look at Panel U Gam Junc
Türpanel, welches mit dem dazugehörigen Transponder aktiviert werden kann, aber es sieht nicht gegen Stöße gesichert aus.

* * *

>teleport to Bridge
Bridge
You can see Bridge Luke and Selbstzerstörungsknopf here.

>teleport to Gamma_Junction
Gamma Junction
Im Boden ist ein riesiges Bodenfenster eingelassen. Es sieht gar nicht mal so stabil aus.

You can see Sicherheitsbarriere, Luke_Hangar, Luke_XenoLab, Sicherheitsbarriere, Panel N Gam Junc, Panel S Gam Junc, LuPanel U Gam Junc and LuPanel D Gam Junc here.

Der Stationsalarm gibt einen ohrenbetäubenden Sirenenton von sich.

>teleport to Xeno_Lab
Xeno Lab
You can see Luke_XenoLab, XenoKnopf and Klappe (closed) here.

Der Stationsalarm gibt einen ohrenbetäubenden Sirenenton von sich.
Durch das Deckenfenster sieht man den grün glühenden  Maschinenkern.
Ein ohrenbetäubendes Pfeifen ist zu hören.

>clap in Hands
Du hast in die Hände geklatscht, doch der Stationsalarm ist zu laut!

* * *

>teleport to Briefing_Room
Briefing Room
You can see Bridge_Luke here.

Der Stationsalarm gibt ein ohrenbetäubenden Sirenenton von sich.

>down
Die Kommandosperre hat die Luke blockiert... nur ein Stromausfall könnte diese Sperre aufheben.

(first opening Bridge_Luke)
It seems to be locked.

>up
You can't go that way.

>west
You can't go that way.

>east
Duty Room
Der Stationsalarm gibt ein ohrenbetäubenden Sirenenton von sich.

>west
Briefing Room
You can see Bridge_Luke here.

Der Stationsalarm gibt ein ohrenbetäubenden Sirenenton von sich.

>d
Die Kommandosperre hat die Luke blockiert... nur ein Stromausfall könnte diese Sperre aufheben.

(first opening Bridge_Luke)
It seems to be locked.

>e
Duty Room
Der Stationsalarm gibt ein ohrenbetäubenden Sirenenton von sich.

>w
Briefing Room
You can see Bridge_Luke here.

Der Stationsalarm gibt ein ohrenbetäubenden Sirenenton von sich.

>w
You can't go that way.

>e
Duty Room
Der Stationsalarm gibt ein ohrenbetäubenden Sirenenton von sich.

>e
Cafeteria
Der Stationsalarm gibt ein ohrenbetäubenden Sirenenton von sich.

>e
You can't go that way.

>w
Duty Room
Der Stationsalarm gibt ein ohrenbetäubenden Sirenenton von sich.

>u
Alpha Junction
You can see Sicherheitsbarriere, Luke_MedLab, Sicherheitsbarriere, Panel N Alp Junc and Panel S Alp Junc here.

Der Stationsalarm gibt ein ohrenbetäubenden Sirenenton von sich.

>n
(first opening Sicherheitsbarriere)
It seems to be locked.

>s
(first opening Sicherheitsbarriere)
It seems to be locked.

* * *

>teleport to Delta_AI
Delta AI
You can see Luke_Delta_AI here.

Der Stationsalarm gibt ein ohrenbetäubenden Sirenenton von sich.
Durch das Deckenfenster sieht man den grün glühenden  Maschinenkern.

* * *

>teleport to Gamma_Delta_Corridor
Gamma Delta Junction
You can see Sicherheitsbarriere, Wartungsluke, Sicherheitsbarriere, Oeffnungshebel, Leiche (on which is Laborkittel), Panel N Gam Del Cor and Panel S Gam Del Cor here.

Der Stationsalarm gibt ein ohrenbetäubenden Sirenenton von sich.

>down
Das Bodenfenster geht kaputt! Der Sauerstoff wird nun weniger im äußeren Ring!

(first opening Wartungsluke)
It seems to be locked.

>take Öffnungshebel
You can't see any such thing.

>take Öffnungshebel
You can't see any such thing.

>take Oeffnungshebel
Taken.

>inv
You are carrying:
  Oeffnungshebel
  Messenger

>drop Messenger
Der Messenger ist Teil deiner Ausrüstung! Diesen kannst du nicht wegwerfen!

>inv
You are carrying:
  Oeffnungshebel
  Messenger

* * *

>teleport to Gamma_Delta_Corridor
Gamma Delta Junction
You can see Sicherheitsbarriere, Wartungsluke, Sicherheitsbarriere, Oeffnungshebel, Leiche (on which is Laborkittel), Panel N Gam Del Cor and Panel S Gam Del Cor here.

Der Stationsalarm gibt ein ohrenbetäubenden Sirenenton von sich.

>go down
Du kannst die Luke nicht öffnen. Der Hebel ist abbgebrochen.

(first opening Wartungsluke)
It seems to be locked.

* * *

>teleport to Gamma_Jucntion
That noun did not make sense in this context.

>teleport to Gamma_Junction
Gamma Junction
You can see Sicherheitsbarriere, Luke_Hangar, Luke_XenoLab, Sicherheitsbarriere, Panel N Gam Junc, Panel S Gam Junc, Panel U Gam Junc and Panel D Gam Junc here.

Der Stationsalarm gibt ein ohrenbetäubenden Sirenenton von sich.

>look at Panel N Gam Junc
Türpanel, welches mit einem Sicherheitsausweis aktiviert werden kann. Es sieht sehr stabil aus.

* * *

>teleport to Hangar
Hangar
You can see Luke_Hangar, Umkleidetür, Spind (in which are Mobitab and Sicherheitsausweis), Drucklufthammer and Panel_Luke_H here.

Der Stationsalarm gibt ein ohrenbetäubenden Sirenenton von sich.

>take Mobitab
Taken.

>teleport to Med_Lab
Med Lab
You can see Luke_MedLab, Dekon Tür, Med-Lab Pult and Kontaminierter here.

Mobi Tab:  Anzahl der Kontaminierten: 1
Der Stationsalarm gibt ein ohrenbetäubenden Sirenenton von sich.
Durch das Deckenfenster sieht man den grün glühenden  Maschinenkern.

>teleport to Fitness
Fitness
You can see three Kontaminierters here.

Mobi Tab:  Anzahl der Kontaminierten: 3
Der Stationsalarm gibt ein ohrenbetäubenden Sirenenton von sich.

>wait
Time passes.

Mobi Tab:  Anzahl der Kontaminierten: 3
Du wurdest kontaminiert!

    *** The End ***

Would you like to RESTART, RESTORE a saved game, QUIT or UNDO the last command?

>undo
Fitness
[Previous turn undone.]

>undo
Med Lab
[Previous turn undone.]

>teleport to Fitness
Fitness
You can see three Kontaminierters here.

Mobi Tab:  Anzahl der Kontaminierten: 3
Der Stationsalarm gibt ein ohrenbetäubenden Sirenenton von sich.

* * *

>undo
Fitness
[Previous turn undone.]

>down
You can't go that way.

Mobi Tab:  Anzahl der Kontaminierten: 3
Du wurdest kontaminiert!

    *** The End ***

Would you like to RESTART, RESTORE a saved game, QUIT or UNDO the last command?

>undo
Fitness
[Previous turn undone.]

>up
You can't go that way.

Mobi Tab:  Anzahl der Kontaminierten: 3
Du wurdest kontaminiert!

    *** The End ***

Would you like to RESTART, RESTORE a saved game, QUIT or UNDO the last command?

>undo
Fitness
[Previous turn undone.]

>west
Crew Quarter
Der Stationsalarm gibt ein ohrenbetäubenden Sirenenton von sich.

>east
Fitness
You can see three Kontaminierters here.

Mobi Tab:  Anzahl der Kontaminierten: 3
Der Stationsalarm gibt ein ohrenbetäubenden Sirenenton von sich.

>wait
Time passes.

Mobi Tab:  Anzahl der Kontaminierten: 3

>wait
Time passes.

Mobi Tab:  Anzahl der Kontaminierten: 3

>wait
Time passes.

Mobi Tab:  Anzahl der Kontaminierten: 3
Du wurdest kontaminiert!

    *** The End ***

Would you like to RESTART, RESTORE a saved game, QUIT or UNDO the last command?

* * *

>teleport to Med_Lab
Med Lab
You can see Luke_MedLab, Dekon Tür, Med-Lab Pult and Kontaminierter here.

Mobi Tab:  Anzahl der Kontaminierten: 1
Der Stationsalarm gibt ein ohrenbetäubenden Sirenenton von sich.
Durch das Deckenfenster sieht man den grün glühenden  Maschinenkern.

>wait
Time passes.

>look
Med Lab
You can see Luke_MedLab, Dekon Tür, Med-Lab Pult and Kontaminierter here.

Du wurdest kontaminiert!

    *** The End ***

Would you like to RESTART, RESTORE a saved game, QUIT or UNDO the last command?

>undo
Med Lab
[Previous turn undone.]

>undo
Hangar
[Previous turn undone.]

* * *

>teleport to Med_Lab
Med Lab
You can see Luke_MedLab, Dekon Tür, Med-Lab Pult, Krankenbett and Kontaminierter here.

>close Dekon Tür
Du willst doch Percy als Erstes dekontaminieren.

>in
Dekontaminationskabine
You can see Dekon Tür and Kontaminierter here.

Der Stationsalarm gibt ein ohrenbetäubenden Sirenenton von sich.
Durch das Deckenfenster sieht man den grün glühenden  Maschinenkern.

>out
Med Lab
You can see Dekon Tür, Luke_MedLab, Med-Lab Pult, Krankenbett and Kontaminierter here.

Der Stationsalarm gibt ein ohrenbetäubenden Sirenenton von sich.
Durch das Deckenfenster sieht man den grün glühenden  Maschinenkern.

>in
Dekontaminationskabine
You can see Dekon Tür and Kontaminierter here.

Der Stationsalarm gibt ein ohrenbetäubenden Sirenenton von sich.
Durch das Deckenfenster sieht man den grün glühenden  Maschinenkern.

>talk with Kontaminierter
Der Stationsalarm ist zu laut!

Du hast den Kontaminierten angesprochen.

* * *

>teleport to Med_Lab
Med Lab
You can see Luke_MedLab, Dekon Tür, Med-Lab Pult, Krankenbett and Kontaminierter here.

>enter Krankenbett
You get onto Krankenbett.

>leave Krankenbett
I only understood you as far as wanting to leave.

>leave
You get off Krankenbett.

Med Lab
You can see Luke_MedLab, Dekon Tür, Med-Lab Pult, Krankenbett and Kontaminierter here.

Du wurdest kontaminiert!

    *** The End ***

Would you like to RESTART, RESTORE a saved game, QUIT or UNDO the last command?

* * *

>teleport to Med_Lab
Med Lab
You can see Luke_MedLab, Dekon Tür, Med-Lab Pult, Krankenbett and Kontaminierter here.

>teleport to Med_Lab
Med Lab
You can see Luke_MedLab, Dekon Tür, Med-Lab Pult and Kontaminierter here.

>teleport to Med_Lab
Med Lab
You can see Luke_MedLab, Dekon Tür, Med-Lab Pult and Kontaminierter here.

Du wurdest kontaminiert!

    *** The End ***

Would you like to RESTART, RESTORE a saved game, QUIT or UNDO the last command?

* * *

>teleport to briefing_room
Briefing Room
You can see Bridge Luke here.

Der Stationsalarm gibt ein ohrenbetäubenden Sirenenton von sich.

>go down
Die Kommandosperre hat die Luke blockiert... nur ein Stromausfall könnte diese Sperre aufheben.

(first opening Bridge Luke)
It seems to be locked.

>unlock Bridge Luke
(with Messenger)
That doesn't seem to fit the lock.

>unlock Bridge Luke with messanger
You can't see any such thing.

>unlock Bridge Luke with messenger
That doesn't seem to fit the lock.

>open Bridge luke
It seems to be locked.

* * *

>teleport to wartungsschacht
Wartungsschacht
You can see Wartungsluke here.

Der Stationsalarm gibt ein ohrenbetäubenden Sirenenton von sich.

>go up
(first opening Wartungsluke)
Die eingeklemmte Palette löst sich. Sie hat sich durch die zugehende Luke so sehr beschleunigt dass das Bodenfenster kaputt geht! Der Sauerstoff wird nun weniger im äußeren Ring!

Gamma Delta Junction
You can see Wartungsluke, Sicherheitsbarriere, Sicherheitsbarriere, Oeffnungshebel, Panel N Gam Del Cor and Panel S Gam Del Cor here.

Der Stationsalarm gibt ein ohrenbetäubenden Sirenenton von sich.

>down
Wartungsschacht
You can see Wartungsluke here.

Der Stationsalarm gibt ein ohrenbetäubenden Sirenenton von sich.

>up
Gamma Delta Junction
You can see Wartungsluke, Sicherheitsbarriere, Sicherheitsbarriere, Oeffnungshebel, Panel N Gam Del Cor and Panel S Gam Del Cor here.

Der Stationsalarm gibt ein ohrenbetäubenden Sirenenton von sich.

>down
Wartungsschacht
You can see Wartungsluke here.

Der Stationsalarm gibt ein ohrenbetäubenden Sirenenton von sich.

>up
Gamma Delta Junction
You can see Wartungsluke, Sicherheitsbarriere, Sicherheitsbarriere, Oeffnungshebel, Panel N Gam Del Cor and Panel S Gam Del Cor here.

Der Stationsalarm gibt ein ohrenbetäubenden Sirenenton von sich.

Es ist kein Sauerstoff mehr vorhanden! Du erstickst!

    *** The End ***

Would you like to RESTART, RESTORE a saved game, QUIT or UNDO the last command?

* * *

>go up
(first opening Wartungsluke)
Die eingeklemmte Palette löst sich. Sie hat sich durch die zugehende Luke so sehr beschleunigt dass das Bodenfenster kaputt geht! Der Sauerstoff wird nun weniger im äußeren Ring!

Gamma Delta Junction
You can see Wartungsluke, Sicherheitsbarriere, Sicherheitsbarriere, Oeffnungshebel, Panel N Gam Del Cor and Panel S Gam Del Cor here.

Der Stationsalarm gibt ein ohrenbetäubenden Sirenenton von sich.

>teleport to Gamma_Junction
Gamma Junction
Das Bodenfenster wurde durch die Palette schwer beschädigt und es entweicht Luft.

You can see Sicherheitsbarriere, Palette, Luke_Hangar, Luke_XenoLab, Sicherheitsbarriere, Panel N Gam Junc, Panel S Gam Junc, Panel U Gam Junc and Panel D Gam Junc here.

Der Stationsalarm gibt ein ohrenbetäubenden Sirenenton von sich.

* * *

>go up
(first opening Wartungsluke)
Die eingeklemmte Palette löst sich. Sie hat sich durch die zugehende Luke so sehr beschleunigt dass das Bodenfenster kaputt geht! Der Sauerstoff wird nun weniger im äußeren Ring!

Gamma Delta Junction
You can see Wartungsluke, Sicherheitsbarriere, Sicherheitsbarriere, Oeffnungshebel, Panel N Gam Del Cor and Panel S Gam Del Cor here.

Der Stationsalarm gibt ein ohrenbetäubenden Sirenenton von sich.

>wait
Time passes.

5

>wait
Time passes.

4

>wait
Time passes.

3

>wait
Time passes.

2

>wait
Time passes.

1Es ist kein Sauerstoff mehr vorhanden! Du erstickst!

    *** The End ***

Would you like to RESTART, RESTORE a saved game, QUIT or UNDO the last command?

>wait
Please give one of the answers above.

Would you like to RESTART, RESTORE a saved game, QUIT or UNDO the last command?

>wait
Please give one of the answers above.

Would you like to RESTART, RESTORE a saved game, QUIT or UNDO the last command?

Please give one of the answers above.

Would you like to RESTART, RESTORE a saved game, QUIT or UNDO the last command?

Please give one of the answers above.

Would you like to RESTART, RESTORE a saved game, QUIT or UNDO the last command?

>wait
Please give one of the answers above.

Would you like to RESTART, RESTORE a saved game, QUIT or UNDO the last command?

>look
Please give one of the answers above.

Would you like to RESTART, RESTORE a saved game, QUIT or UNDO the last command?

>n
Please give one of the answers above.

Would you like to RESTART, RESTORE a saved game, QUIT or UNDO the last command?

>s
Please give one of the answers above.

Would you like to RESTART, RESTORE a saved game, QUIT or UNDO the last command?

>u
Please give one of the answers above.

Would you like to RESTART, RESTORE a saved game, QUIT or UNDO the last command?

>d
Please give one of the answers above.

Would you like to RESTART, RESTORE a saved game, QUIT or UNDO the last command?

>u
Please give one of the answers above.

Would you like to RESTART, RESTORE a saved game, QUIT or UNDO the last command?

* * *

>transp
Nicht möglich!

>go north
Gamma Beta Corridor

* * *

>go north
Alpha Junction

>go north
Alpha Delta Corridor

* * *

>go up
Duty Room

>go eat
You can't see any such thing.

>go east
Cafeteria

* * *

>transp
Transporter Module

>transp
Transporter Raum

* * *

>transp
Nicht möglich!

>look
Transporter Module

>go south
You can't go that way.

>go north
Antenna Array SM

>go down
Lab Module

>go west
You can't go that way.

>go east
Storage SM

>go up
You can't go that way.

>go down
Damaged Module

>go south
Energy Module

>go west
Delta Grennhouse SM

>go up
Com Module

>go up
You can't go that way.

>go west
You can't go that way.

>go east
Control Module

>go up
Pulsator Module

>go north
Solar Module

>transp
Transporter Module

>go north
Antenna Array SM

* * *

>go down
Lab Module

>go east
Storage SM

>go down
Damaged Module

* * *

>go west
Delta Grennhouse SM

>go north
You can't go that way.

>go up
Com Module

>go east
Control Module

* * *

>transp Hangar
You can't see any such thing.

>transp Gamma_Delta_Corridor
You can't see any such thing.

* * *

>u
(first opening Deckenluke)
It seems to be locked.

Der Stationsalarm gibt ein ohrenbetäubenden Sirenenton von sich.

I beg your pardon?

>d
Der Alarm der Station gibt ein Ohrenbetäubenden Sirenenton von sich.

* * *

>d
Der Alarm der Station gibt ein Ohrenbetäubenden Sirenenton von sich.

* * *

>d
You can't go that way.

>u
Der Alarm der Station gibt ein Ohrenbetäubenden Sirenenton von sich.

>u
Der Alarm der Station gibt ein Ohrenbetäubenden Sirenenton von sich.

* * *

>u
You can't go that way.

* * *

>u
(first opening Deckenluke)
It seems to be locked.

Der Stationsalarm gibt ein ohrenbetäubenden Sirenenton von sich.

>d
Hangar
Der Stationsalarm gibt ein ohrenbetäubenden Sirenenton von sich.

* * *

>d
Docking Bay
Der Stationsalarm gibt ein ohrenbetäubenden Sirenenton von sich.

>d
Der Alarm der Station gibt ein Ohrenbetäubenden Sirenenton von sich.

Docking Bay

>d
You can't go that way.

>u
Der Alarm der Station gibt ein Ohrenbetäubenden Sirenenton von sich.

Hangar

>u
Der Alarm der Station gibt ein Ohrenbetäubenden Sirenenton von sich.

Gamma Junction
You can see Sicherheitsbarriere, Sicherheitsbarriere, TestTür, TestPanel, Mobitab and Panel Norden here.

>u
Der Alarm der Station gibt ein Ohrenbetäubenden Sirenenton von sich.

Xeno Lab

>u
You can't go that way.

* * *

>u
Hangar
Der Stationsalarm gibt ein ohrenbetäubenden Sirenenton von sich.

I beg your pardon?

>u
Gamma Junction
Der Stationsalarm gibt ein ohrenbetäubenden Sirenenton von sich.

You can see Deckenluke, Sicherheitsbarriere, Sicherheitsbarriere, Mobitab and Panel Norden here.

Der Stationsalarm gibt ein ohrenbetäubenden Sirenenton von sich.

* * *

>d
Hangar
Der Stationsalarm gibt ein ohrenbetäubenden Sirenenton von sich.

>n
(first opening Sicherheitsbarriere)
It seems to be locked.

>n
(first opening Sicherheitsbarriere)
It seems to be locked.

>u
Xeno Lab

* * *

>d
Hangar
Der Stationsalarm gibt ein ohrenbetäubenden Sirenenton von sich.

>u
Der Alarm der Station gibt ein ohrenbetäubenden Sirenenton von sich.
Der Maschinenkern erleuchtet den Raum Xeno Lab grün.

Xeno Lab

>d
Gamma Junction
You can see Sicherheitsbarriere, Sicherheitsbarriere, TestTür, TestPanel, Mobitab and Panel Norden here.

* * *

>u
Der Alarm der Station gibt ein ohrenbetäubenden Sirenenton von sich.
Der Maschinenkern erleuchtet den Raum Xeno Lab grün.

Xeno Lab

>u
You can't go that way.

>n
You can't go that way.

>s
You can't go that way.

>w
You can't go that way.

* * *

>e
You can't go that way.

>d
Der Alarm der Station gibt ein ohrenbetäubenden Sirenenton von sich.

Gamma Junction
You can see Sicherheitsbarriere, Sicherheitsbarriere, TestTür, TestPanel, Mobitab and Panel Norden here.

* * *

>u
(first opening Deckenluke)
It seems to be locked.

Der Stationsalarm gibt ein ohrenbetäubenden Sirenenton von sich.

>s
You can't go that way.

>d
Gamma Junction
You can see Sicherheitsbarriere, Sicherheitsbarriere, TestTür, TestPanel, Mobitab and Panel Norden here.

>u
Xeno Lab

>d
Gamma Junction
You can see Sicherheitsbarriere, Sicherheitsbarriere, TestTür, TestPanel, Mobitab and Panel Norden here.

* * *

>u
(first opening Deckenluke)
It seems to be locked.

Der Stationsalarm gibt ein ohrenbetäubenden Sirenenton von sich.

>u
You can't go that way.

* * *

>use Led-Lab Pult
You can't see any such thing.

>use Med-Lab Pult
You can't see any such thing.

>interact with Med-Lab Pult
Das interressiert dich nicht. Da müsste erst ein Freund kontaminiert sein.

>interact with Med-Lab Pult
Das interressiert dich nicht. Da müsste erst ein Freund kontaminiert sein.

>interact with Med-Lab Pult
Das interressiert dich nicht. Da müsste erst ein Freund kontaminiert sein.

Du wurdest kontaminiert!

    *** The End ***

Would you like to RESTART, RESTORE a saved game, QUIT or UNDO the last command?

* * *

>w
You can't go that way.

>d
Der Alarm der Station gibt ein ohrenbetäubenden Sirenenton von sich.

Hangar

>d
Der Alarm der Station gibt ein ohrenbetäubenden Sirenenton von sich.

Docking Bay

* * *

>wait
Time passes.

Der Stationsalarm gibt ein ohrenbetäubenden Sirenenton von sich.

>wait
Time passes.

>testi
Med Lab
You can see Deckenluke, Kontaminierter and Med-Lab Pult here.

Der Stationsalarm gibt ein ohrenbetäubenden Sirenenton von sich.
Durch das Deckenfenster sieht man den grün glühenden  Maschinenkern.

>wait
Time passes.

>teleport to Med_lab
That's not a verb I recognise.